00011010010110011111011101010011111011111011
00010111101101101100111011111110010101001111
00010110101111011000111111110011011111010011
00010101001010011111110111111010001111011111
00010100111111101111001111011011110100011011
00010011100111010111011011100011111111011011
00010010110111010110011011100110111111011111
00001101010110111111011100111011110010011111
00001010101111101101000111111100111111101101
00001001100111100110100111101011111111011111
