000000001000000011000000101000000111
000000001000000101000010001000010101
000000001000000111000000101000000011
000000001000001001001000001001001001
000000001000010001100000001100010001
000000001000010101000010001000000101
000000001000100001000000011000100011
000000001001000001000001001001001001
