000000111011011011110111010101111
000001110110001101101101111110111
000100110101111001101011110101111
000100110111100110101111010011111
000101001111100010111110111101101
000101010110111110011100110111101
000101101111001110101110100111011
000101101111111100011101110100011
000110010100101111110110011011111
000111001001011011010101111110111
