0000110101001000101111101100111000011010101000111
0000110101001000101001000101111101100111100100111
0000110001101010110000111001101111101000100101011
0000101111001101010011100100100010110000111010111
0000101111001101010011100100100010110000110011111
0000101111001101010001100100100010110000111011111
0000101110001101010011100100100010110000111011111
0000101101010101010001100111110011110010011000011
0000101101010001010001110111110011110010011000011
0000101100010011100011111110100011101000101001011
0000101100010011100011111110100010101001101001011
0000101000111011101001000110111101001011001000111
0000101000111011001001000110111101011011001000111
0000101000101011101001000110111101011011001000111
0000100111110110011111000101000100101010000110111
0000100111110110011111000100100100101010000110111
0000100111110000110010101101000110001010101110111
0000100111110000110010001101000110001010111110111
0000100111010110011111000101100100101010000110111
0000100111010000110010101101000110001010111110111
0000100101111001111101000110001101100101010000111
0000100101111001111101000110001100100101010100111
0000100101100111110000110111010000101100101110101
0000100101100111101011000110111011100001010100101
0000100101100111101011000110111010100011010100101
0000100101100111010001100101100111110001001110101
0000100101100111010001100101100101110001101110101
0000100101100111010000100101100111110001101110101
0000100101100110111000110111010000101100101110101
0000100101100101100111110001100001101110101010101
0000100101100101100111110001010001101110101010101
0000100101100011111000110111010000101100101110101
0000100101100011101011000110111011100011010100101
0000100101000100101100111110001101110001101110101
0000100101000100101100111110001001110101101110101
0000100101000100101100011110001101110101101110101
0000100101000100100100111110001101110101101110101
0000100100100111010001100101100111110001101110101
0000100100100101100111110001110001101110101010101
0000100100011110011101100011111011000101001101001
0000100100011110011001100011111011000101011101001
0000100100011110010101100011111011000101011101001
0000100100010110111001101011111000100011000101111
0000100100010110111001101011011000100011010101111
0000100100010110101001101011111000100011010101111
0000100011100101101011101101010001101100101010011
0000100011100101101001101111010001101100101010011
0000100011100101001011101111010001101100101010011
0000100011011001010101001110000100101111001111101
0000100001001011001111010110001101110111000110101
0000011110110010111000101001000010100110011011111
0000011101101111010111000110010010100010100001111
0000011101101111010111000100010010100110100001111
0000011101101111010101000110010010100110100001111
0000011100110010111000101001000110100110011011111
0000011011000110010111101001000101000111011011011
0000011011000110010111100001000101000111011011111
0000011011000110010111001001000101000111011011111
0000011001011110011111001000111011100010100001011
0000011001011110011101001000111011100010100101011
0000011001011110011011001000111011100010100101011
0000011000110110010101010011100001001011110011111
0000011000011110011111001000111011100010100101011
0000010111110110101001000101100001101011001100111
0000010111110110101001000100100001101011101100111
0000010111011001100101100010010100011101001101111
0000010110111101011110011000100110000100010011111
0000010110111101010110011000100110100100010011111
0000010110110101011110011000100110100100010011111
0000010101011001110000110101001000101111101100111
0000010101010110100001100001100100111100111110111
0000010101000110110010010111101100100111011100011
0000010101000110110010010111101100001111011100011
0000010101000110110010010111100100101111011100011
0000010101000110110010010011101100101111011100011
0000010100110100001111000001110110111101011100011
0000010100101100101110001011111110001110010001101
0000010100101011110100010011011101000111001101011
0000010100101011100100010011011111000111001101011
0000010100101001011000100111001110001111011101101
0000010100011101110100100011011110101101100100011
0000010011101000110001000101011111011100110011011
0000010011011001100111011111010100010001100010111
0000010011000110010111101001000101000111011011111
0000010010111111100011101100010100101001110100011
0000010010111111100001101100010100101101110100011
0000010010111110100011101100010100101101110100011
0000010010111101100011101100010100101101110100011
0000010010111101100001010100011010011110110010111
0000010010111011110001110011100100011010110100101
0000010010110101100001010100011010011111110010111
0000010010101101111101000001110011011101011000011
0000010010011110011111011100010101010101101000011
0000010010001011111011001111011001110000110101001
0000010001110010101000100110111011111011000110011
0000010001100010111001001001101100110011101111101
0000010000111101100001010100011010011111110010111
0000010000101111100110100101100011111001010111001
0000010000101111100110100101100011111001010110011
0000010000101111000110100101100011111001010111011
0000010000101011100110100101100011111001010111011
0000001111011001011100010100100011010011001101111
0000001110011010000100000110110111110011100011111
0000001110011010000100000110101111110011100011111
0000001110010010000100000110111111110011100011111
0000001101011010010100000101101110111100011100111
0000001100101010110110101100110001100011010011111
0000001100101010110110100100110011100011010011111
0000001100100010110110101100110011100011010011111
0000001011110010101011100101101110110000100100111
0000001011100101101011111110101000100001010101011
0000001011100101101011111110001000101001010101011
0000001011100101101011111100101000101001010101011
0000001011100001101011111110101000101001010101011
0000001011100001001011001011100111001001110111011
0000001011010010101011100101101110110001100100111
0000001011000001001111001011100111001001110111011
0000001010110101010100010111010111111100101000011
0000001010110101010100010111000111111100101001011
0000001010110101010000010111010111111100101001011
0000001010100111000100100110011000110111110111011
0000001010010101111010001001101111100011100110101
0000001010010011000110111011010011101010100111101
0000001010010001011111011001111011001110000110101
0000001001100110001101111101110110010001010100111
0000001001100001001111001011100111001001110111011
0000001000010110011100000011111000111001111111101
0000000101111001011100101011100100101110011001011
0000000101111001011100101011100100101100111001011
0000000101111001011100101011100100101010111001011
0000000101111001010101110010110111011000110010011
0000000101111001010100101011100100101110111001011
0000000101101101010010001111110101110110010010011
0000000101101101010010001111100111110110010010011
0000000101101101010010001110110111110110010010011
0000000101101101000010001111110111110110010010011
0000000101011111011100110011011001001001110100011
0000000100111011001000001111101111111100001000111
0000000100111011001000001111101110111100011000111
0000000100111011001000001111001111111100011000111
0000000100101011110100010011011111000111001101011
0000000100100111100110101110001001100011110101111
0000000100100111100110100110001001101011110101111
0000000100100111100010101110001001101011110101111
0000000100100101100100111111110001101101110100101
0000000100100101100100111111110001001101110110101
0000000100100101100000111111110001101101110110101

