00000000000001011
00000000000010011
00000000000100011
00000000000100101
00000000001000011
00000000001000101
00000000010000011
00000000010000101
00000000010001001
00000000100000011
00000000100000101
00000000100001001
00000001000000101
00000001000001001
00000001000010001
00000010000010001
