000000010100010101010100010101010101
000000010101000101000101010101010101
000001000011000011000101000111000111
000001000011000101000011001001001111
000001000011000101001011001001000111
000001000011000111000101000111000011
000001000011001101001011000001000111
000001000101000101010001010101010101
000001000101010100010101000101010101
000001000101010101000101010100010101
000001000101010101010001010101000101
000001000111000001001011001101000011
000001000111000111000101000011000011
000001000111001001001011000101000011
000001001000001011000011001010011011
000001001000001011010011001010001011
000001001000011001010001011000011011
000001001000011001010001011010011001
000001001000011011000011001010001011
000001001000011011010001011000011001
000001001000101001100001101000101101
000001001000101001100001101100101001
000001001000101101000101001100001101
000001001000101101100001101000101001
000001001001000001001001010011011011
000001001001000001001001100101101101
000001001001000001001011010011011001
000001001001000001011001010011001011
000001001001000011001001010001011011
000001001001000011001011010001011001
000001001001000011011001010001001011
000001001001000011011011010001001001
000001001001000101001001100001101101
000001001001000101001101100001101001
000001001001000101101001100001001101
000001001001010001001001000011011011
000001001001010001001011000011011001
000001001001010001011001000011001011
000001001001010001011011000011001001
000001001001010011001011000001011001
000001001001010011011001000001001011
000001001001100001001001000101101101
000001001001100001001101000101101001
000001001001100001101001000101001101
000001001001100101001101000001101001
000001001001100101101001000001001101
000001001010001001000011001010011011
000001001010001001000011011010001011
000001001010001011000011001000011011
000001001010001011000011001010011001
000001001010001011010011001000001011
000001001010011001000011001010001011
000001001010011001010001011000011001
000001001010011011000011001000001011
000001001011000011001001010001011001
000001001100001001000101001100101101
000001001100001001000101101100001101
000001001100001101000101001000101101
000001001100101001000101001100001101
000001001111001001000011000101000011
000001010001010001000101010101010101
000001010001010101010100010001010101
000001010100010001010001010101010101
000001011000011001010001001000011011
000001011001010001001001000011001011
000001011010001001000011001010001011
