0000000000000001001011000110101
0000000000000010001100101010011
0000000000000010100100011010101
0000000000000100010000111110001
0000000000000100010001101011001
0000000000000110001001001001011
0000000000000110010100000010111
0000000000001000100010010001111
0000000000001001001000100011101
0000000000001001010100000010111
0000000000001010001011000100101
0000000000001100000010100100111
0000000000001101000010000101011
0000000000010000011000100110101
0000000000010000100001000011111
0000000000010000101000001111001
0000000000010001001000001110101
0000000000010010000110010101001
0000000000010010001100001100101
0000000000010010010110000101001
0000000000010011000011000001011
0000000000010100001001101000011
0000000000010100100000001110011
0000000000010100100100100000111
0000000000010110000001010100011
0000000000100000000011101010011
0000000000100000110010101000011
0000000000100001010100001101001
0000000000100001100010100100101
0000000000100001100110000101001
0000000000100010000010000111101
0000000000100100000011100100101
0000000000100100001000101001101
0000000000100100001010101001001
0000000000100110000110000010101
0000000000101000000000111100011
0000000000101000000001101100011
0000000000101000001100100010101
0000000001000000000100011011011
0000000001000000000100101010111
0000000001000010000000101011101
0000000001000010001010110000011
0000000001000010010000101010101
0000000001000011001000100110001
0000000001000100011000001001101
0000000001000100011010000001011
0000000001001000001001000001111
0000000001001000100000110100101
0000000001001100001100001000101
0000000001010000001001110000011
0000000001010000001100100100101
0000000001010000010110000010011
0000000001010001100010010000011
0000000001010010010110000000011
0000000001100000010000010110011
0000000001100001000010101000011
0000000010000000010000111110001
0000000010000000010100001110011
0000000010000000101100101000101
0000000010000010000010010111001
0000000010000010001100100010101
0000000010000011101001000100001
0000000010000100001010100110001
0000000010000100110000011001001
0000000010000100110100001010001
0000000010000111000001000010011
0000000010001000010001101000011
0000000010001000010100000101011
0000000010001000010100110001001
0000000010001000011100001000101
0000000010001010010010000100011
0000000010001101000001100000101
0000000010010000100000100010111
0000000010010000100000100110011
0000000010010001011000010000101
0000000010010100010001000000111
0000000010011000000100000011101
0000000010011000000110010000101
0000000010011000010100001000101
0000000010100000100010011000011
0000000010100001000101100000011
0000000010100100110000100000011
0000000010101000010001100000011
0000000010110000000100001010011
0000000100000001000001100011101
0000000100000010011010010010001
0000000100000100000001001010111
0000000100000100100010000101101
0000000100000100110010001000101
0000000100000101100100010000101
0000000100000111000000101100001
0000000100000111001000000101001
0000000100001000000010010110011
0000000100001000001001110100001
0000000100001000010001011001001
0000000100001000011000001011001
0000000100001001001010001000101
0000000100001010010000001100101
0000000100001010010001000100101
0000000100001100110000001000101
0000000100001100110000100001001
0000000100010000011000010001101
0000000100010010001010000010011
0000000100010100100010000001011
0000000100100000010000001100111
0000000100100000010000100011101
0000000100100001000001010010011
0000000101000100000110001000101
0000000101001001000000100010011
0000000111000000100000010000111
0000001000000100000010001011011
0000001000000100000010001111001
0000001000000100001000001110101
0000001000000100001010100011001
0000001000000101101000000100011
0000001000001000000100001110101
0000001000001000001000001001111
0000001000001000011100100001001
0000001000001010000001000110011
0000001000001010001000010001101
0000001000001010100100010000101
0000001000001011100010000100001
0000001000001100001000000101101
0000001000001100001000101000011
0000001000001100001001001000011
0000001000010001000000111000011
0000001000100010001001001001001
0000001000100010010010100001001
0000001000100100110000100000101
0000001001000010001000001100011
0000001001000011000010000010011
0000001001000100010000010100101
0000001010000010001000100000111
0000001010000010010000100010011
0000001100001000010001000001011
