00000000010111
00000000100111
00000001001011
00000001010011
00000010000111
00000010001011
00000010001101
00000010010011
00000010010101
00000010100011
00000100001011
00000100010011
00000100010101
00000100100011
00000100100101
00000101000011
00001000010011
00001000100011
00001000100101
00001001000101
