0000000000000001011
0000000000000010011
0000000000000100011
0000000000000100101
0000000000001000011
0000000000001000101
0000000000010000011
0000000000010000101
0000000000010001001
0000000000100000011
0000000000100000101
0000000000100001001
0000000001000000011
0000000001000000101
0000000001000001001
0000000001000010001
0000000010000000101
0000000010000001001
0000000010000010001
0000000100000010001
0000000100000100001
