001111111011011011111111101111010101111111111111111111111111
001101111101111111101011110111111001111111111111111111111111
001011110111111110110111011111011110111111111111111111111111
001011110111111111110011011111011110111111111111111111111111
001111100111111110110101111111101110111111111111111111111111
001110011111111101101111110101111111011111111111111111111111
001011011111110111110111011110111111011111111111111111111111
001111111101101110111101111101011111011111111111111111111111
001110110111111111101011111011101111011111111111111111111111
001110111101111101011111111011011111101111111111111111111111
001011111111111110011101111101011111101111111111111111111111
001111111111111011011011110101011111101111111111111111111111
001111111011010111111011111011101111101111111111111111111111
001111101111111011111011101111110101101111111111111111111111
000110111111011011111011111111011111110111111111111111111111
001111111110110111111011110111010111110111111111111111111111
001111111111011011111011101111101011110111111111111111111111
001111111101101011111011111111101101110111111111111111111111
001111111110110111101111111110101110110111111111111111111111
001101111111101111011111011111110101111011111111111111111111
001111010101111111101111011111111111011011111111111111111111
001111101011111111101110111111111101011011111111111111111111
001111011110111011011111111111101111101011111111111111111111
001001111101101111011111111110111111111101111111111111111111
001011011111101110111111101111101111111101111111111111111111
001111011101101011111111011111110111111101111111111111111111
001011111110111011110111111011111011111101111111111111111111
001101111111111110101111110110111101111101111111111111111111
001111101101111111111010111101111111011101111111111111111111
001110111111101011110111111111101111101101111111111111111111
001111111111111111011011110111101011101101111111111111111111
000111010111111011011111111111011111111110111111111111111111
001111011111111011011101111101011111111110111111111111111111
001011011110111111011111111011101111111110111111111111111111
001111111111101101111101011011101111111110111111111111111111
000111011111110110111111011111110111111110111111111111111111
001111111011010111111111011111011101111110111111111111111111
001101111111010111111011111111011111011110111111111111111111
001111110101110111111011110111111111110110111111111111111111
001111011110111011011111111111101111111010111111111111111111
001111111111101101111111011111011101111010111111111111111111
000110111111011111110111110110111111111111011111111111111111
000101111011111011111111101111011111111111011111111111111111
001110110111111011111011111111010111111111011111111111111111
001111101010111111111101101111111111101111011111111111111111
001011110111011111011111111101111111111110011111111111111111
001101011111110111111011111111011111111110011111111111111111
001101111010111111111111001111101111111111101111111111111111
001111110111101111111110111010110111111111101111111111111111
001110111110110101111110111111111110111111101111111111111111
001011111111101111111011111011110111011111101111111111111111
001111111111011011110111111111011101011111101111111111111111
001111110101101111111111011111111011111011101111111111111111
001110101111111011110111111111101111111101101111111111111111
001111101011011111111011111011101111111111110111111111111111
001111110110111111111011110111010111111111110111111111111111
001110111110111111101111111111110101111110110111111111111111
001111111110111111111110111010111111011110110111111111111111
001111111111011111111011111111011101011110110111111111111111
001111111111110111111111011111110110111010110111111111111111
001111111111101111110101011011011111111111111011111111111111
001101111101111011111101111101011111111111111011111111111111
001111101111111011101111101101011111111111111011111111111111
001111110111111111011011110111010111111111111011111111111111
000111011111111011111110110111111011111111111011111111111111
001011011101111011111110111111111101111111111011111111111111
001101011111111011111111111001111110111111111011111111111111
001111111111101111110111111111101110101101111011111111111111
001111111111101111111011111111101101110101111011111111111111
001111011010111111011111111111101111111110111011111111111111
000111011011111111110111111111110111111111011011111111111111
001111101111111111110111111111101110111101101011111111111111
001110101101111111011111111011011111111111111101111111111111
001111111101111111011010111011011111111111111101111111111111
001011111011101111110111101111101111111111111101111111111111
001011111011111101111011111011101111111111111101111111111111
001111011111111101011111011011101111111111111101111111111111
001111111111101111110110101110101111111111111101111111111111
001101011111111110111111001111111101111111111101111111111111
001101011111101110111111111111111111010111111101111111111111
001111111101110101101111111011111111111011111101111111111111
000101111101111111111011111111111101111011111101111111111111
001111111110110101101110111111111111111101111101111111111111
001010111111101111111111011111101111111101111101111111111111
001111111101011101101111111111111011111110111101111111111111
001101111110101110111111111111111111110110111101111111111111
001111111110101110110111111111111111110110111101111111111111
001101111111111111111111111110011111101101011101111111111111
001111111011011101111101111111111111111110101101111111111111
001111111011111111111111011111011101111110101101111111111111
001011111101111111011101111011111011111111111110111111111111
001101011011111101111111111011111111011111111110111111111111
001110110101111111110111111111011111011111111110111111111111
001111111011111111110111111011010111011111111110111111111111
001110110111111111110101111111101111101111111110111111111111
001011101111011111011111111111111111101011111110111111111111
001010111110111111110111111111111110111111011110111111111111
000111111110111110111111111111111110111011011110111111111111
001101011011111101111111111111111111011111101110111111111111
001111101011011111111111111101111111101111101110111111111111
000111111110111110111111111111111110111101101110111111111111
001101111010111101111111111111111111111110101110111111111111
001110110111111111111111111111100111111110101110111111111111
001111101101111111111111111101111111011101111010111111111111
001111011010111111011111111111111111111110111010111111111111
001111110111111111011010111011110111111111111111011111111111
001111101111111111011101011011110111111111111111011111111111
001111110111111111011110111010110111111111111111011111111111
001111101010111101111111111111101101111111111111011111111111
001110101111111101111111111011011111111101111111011111111111
001001111101111111111011111111111110111101111111011111111111
001111111110111010110110111111111111111110111111011111111111
001111111111011101011011110111111111111110111111011111111111
001001111101111111111111111110111111111101101111011111111111
001111111111011111101111111111111101111011010111011111111111
001111111101111011111111111111111111101101010111011111111111
001111111011110111010111111111111111110111111011011111111111
001111101110101111111111111111101111111101111011011111111111
001110111111111111111111111101011111011011111101011111111111
001111011101101111111111111110111111111101111101011111111111
001110111111111111111111111011011111101101111101011111111111
001111011011111101111111111111101111111111011101011111111111
001111110111111111011011111111111111101111011101011111111111
001111011111111101111111111111101111111011011101011111111111
001111101111111111011111111111111101110111101101011111111111
001011111111101111100110111101111111111111111111101111111111
001011101111111101101111011110111111111111111111101111111111
000110111110111111101111110110111111111111111111101111111111
001101011111101111101111111010111111111111111111101111111111
001101111101111110111101011111011111111111111111101111111111
001111111101111101111111011010101111111111111111101111111111
001011101101111111110111101111111011111111111111101111111111
000110111110111111110111111101111110111111111111101111111111
001110101111111011011111111111111111101101111111101111111111
001110101111111011110111111111111111101101111111101111111111
001011111111111111101111011101111101111110111111101111111111
001110111110110111111111111111110101111110111111101111111111
001001111101111111101111111111111111011110111111101111111111
001011111111111111101111101110111101111111011111101111111111
001110101101111011111111111111011111111111101111101111111111
001110101101111111110111111111111110111111101111101111111111
001110111111101011110111111111111111111101101111101111111111
001110101111111011111111111111011111111101101111101111111111
001101111111111111111111111011101111011110101111101111111111
001110111111101011111111111111111111111101001111101111111111
001111110110111111111111111110101110111111110111101111111111
001011110111111111101111111111111111011011111011101111111111
001111101111111111110111111111111110101101111011101111111111
000111111101111011111111111111111111111011011011101111111111
001111101101111011110111111111111111111111101011101111111111
001111101101111011111111111111011111111111101011101111111111
001111101101111111111111111111011110111111101011101111111111
001111101111111011111111111111011111111101101011101111111111
001111101111111111111111111111011110111101101011101111111111
001111111101111110110111101111111111111111101110101111111111
001111111110111111101111111111111101111101110110101111111111
001111101110111111111111111111110111111110110110101111111111
001101011101111111111111111111111101111110111111001111111111
001110110111111110111101011111011111111111111111110111111111
001111101111111101110111101101011111111111111111110111111111
001011111001111011111111111011101111111111111111110111111111
001111101111111111110101101111011101111111111111110111111111
001111011111111111101011011101111111011111111111110111111111
001111110111111110110101110111111111101111111111110111111111
001110110111111111111011111011111111010111111111110111111111
001110110111110111111011111111111111110101111111110111111111
001011111111111111110111111011110111011111011111110111111111
000111011111111011111111111111110111111011011111110111111111
001101011111111011111111111111011111111111001111110111111111
001111110111111111111011111111111110110101110111110111111111
001011111101111111111111111011101111111011111011110111111111
001101111111111111011111111111011111101011111011110111111111
000111011011111111111111111011011111111111111110110111111111
001110111111101111110101111111111111111111110110110111111111
001111101111111111111101101111011101111111111111010111111111
001110111111111111111111111011110110111110111111010111111111
001111011111110111111111111110111111111110110111010111111111
001111111101111111011111011111111111111110111011010111111111
001111111101111101011110111011011111111111111111111011111111
001101111110111101111101111101011111111111111111111011111111
001111010111111111101101111011101111111111111111111011111111
001111011011101111110111111111111101011111111111111011111111
001111101111111111110101101111111011101111111111111011111111
000111011011111111111011111111111110110111111111111011111111
001011101111111111011111110111101111111101111111111011111111
001001111101111111011111111111111110111101111111111011111111
001110111110101101111111111111111101111110111111111011111111
001101111111011111011111111111111101011110111111111011111111
001111010111011111111111011111111111110110111111111011111111
001111101111111111111111101110111111101101011111111011111111
001111011111111111111111111011101111110110101111111011111111
001011110111011111111111101111101111111111111011111011111111
000101111111111111111111111111011111101111011011111011111111
001011101111111111111111111011111011110111111101111011111111
001011101111111111011111111111111111100111111101111011111111
001111101110101111110111111111111111111111101101111011111111
001111111101011101111110111111111111111111101101111011111111
001110101111111111111101111111111111101101111111011011111111
000111011111111111111111011111110111111110111111011011111111
001101011111011111111111111111111101111110111111011011111111
001111011111010111111111111111111111111110110111011011111111
001111101111011011111111111111110111111111111011101011111111
001101101111111111010111101111011111111111111111111101111111
001110101111111110110111111111101111110111111111111101111111
001110101110111111111110111111111111101101111111111101111111
001111101110111111111101111111111110110101111111111101111111
001111101110111111111110101101111111111110111111111101111111
001111011111111111111101011111111101101110111111111101111111
001110101111111110111111111111111110110110111111111101111111
001011101111011111111111111100111111111111011111111101111111
001111011111111111111101101110111111111101011111111101111111
001011011111101111111111110111011111111111111011111101111111
001011111111111011111111111111111100111011111011111101111111
001110111111111111111111111101011111111011011011111101111111
001101111111110101111011111011111111111111111101111101111111
001011111111111101111110111101111111111111011101111101111111
001011101111111110111111111100111111111111111110111101111111
001011101111111111011111111101011111111111111110111101111111
001011101111111111111101011111111101111111111110111101111111
001011111111111111011101111101111111111101111110111101111111
001101101111111111111111111110101111111110111110111101111111
001111101111111111011010111101111111111111111111011101111111
001111101111111110111111111111111101101011111111011101111111
001111110111111111111101110111110111111111111110101101111111
001101101111111111110111101111011111111111111111110101111111
001101101111111111110111101111111111110111111111110101111111
001101111110111111111111111101011111111111111101111001111111
001101111101011111111111100111011111111111111111111110111111
000110111111111101111101101111111110111111111111111110111111
001111101110111111110101101111111111101111111111111110111111
000110111111011111011111111111110111110111111111111110111111
001110111111111111010110111110111111111011111111111110111111
000110111101111101111111111111111101111101111111111110111111
000110111111111011111111110111110111111111011111111110111111
001110111111110101111111111111111111111101101101111110111111
001011111111011111111111111110111011110111111110111110111111
001111101101111111110110101111111111111111111111101110111111
001011111111111111100111101111111111111101111111101110111111
001111011111111111111111111101011111111101111101101110111111
000111011111111111111011111111111111011011111111110110111111
001111011101111111111101111111111011011111111111111010111111
001110111111111110110110111111111111111101111111111010111111
001111011101111111111111111101111111101101111111111010111111
001111011111111110111111110110111111111111111110111010111111
001111101111111101011011110111011111111111111111111111011111
001110111111110110111111010111110111111111111111111111011111
001111101110111101101111111111101011111111111111111111011111
001101111111111010111101101111111101111111111111111111011111
001110111111110110111111111010111110111111111111111111011111
001110110111111111010111111110111111110111111111111111011111
001101111111101011111111111111011011110111111111111111011111
001110111111101011111111111111101111101101111111111111011111
001011111110111011111111111111101111011110111111111111011111
001101111011111101111111111111011111111110101111111111011111
001101111111011111111111111111011111111010110111111111011111
001110111111111101011111101101111111111111111101111111011111
001101111111101111111111111111011111111010111101111111011111
001011111111111101111111111111101111011111011101111111011111
001011111111111101111111111111101111101110111111101111011111
001101111101111111111101111111011111111111111110101111011111
001011111111111110111111111111011110110111111111110111011111
001011111111111111111011111111011110110111111111110111011111
001110111101101111111111111101011111111111111111111011011111
001101111011111111110111111111111111101011111111111011011111
000111011111111111011111111111110111111110111111111011011111
001101111111110111101111011111111110111111111111111101011111
001110111111111110110111111111011111110111111111111101011111
001111011111110111011011111101011111111111111111111111101111
001111010111111011011111111111011101111111111111111111101111
001110111111110110111111101111110101111111111111111111101111
001101111111011111101111101111111010111111111111111111101111
001111011011101111111110101111111111111101111111111111101111
001101111111101111111111011111101111111010111111111111101111
001101111111111011111111111111011111101111101011111111101111
001011011111101111111111101110111111111111111101111111101111
001011111111111111111101110111111011111111111001111111101111
001110111111111111111111101111110101111111110110111111101111
001110111111111101101111101011111111111111111111011111101111
001011101111111110111111111101111111101111111111011111101111
001101111111111011111111111111011111010111111111011111101111
001011111011111111111011111111101111111111110111011111101111
001011111101111111110111111111111011101111111111101111101111
001011111101111111110111111111111101110111111111110111101111
001101111111111111110111111101011111111111101111110111101111
001101111111111111111110111111011111111101111111010111101111
001011111111011111111111111111101111110111111011111011101111
001101111110110111111111111110101111111111111111111101101111
001101111111111010111111011111111101111111111111111101101111
000110111111111101111110111111111110111111111111111101101111
001101111111111111111111011111111101111010111111111101101111
001101111110111111111110110111111111111101111111111110101111
001101111111011111111111111111011111111001111111111110101111
001101111111111101111110111110111111111111101111111110101111
001011111111011111111111101111111110111011111111111111001111
001011111111111001111101101111111011111111111111111111110111
001011111011110111111111011111111101111111110111111111110111
001011111111101111111101111111011111011111111011111111110111
001011111101111111111011111111101111101111111111011111110111
001011111111111101111101111111101111111011111111101111110111
001011111110111110111111111110111111111110111111111111010111
001011111111111111111101111111101111111111101011111111100111
001101111110101111101111111111101111011111111111111111111011
001011111101011110111111111111111101111111011111111111111011
001010111111110111111111111111111110110111111011111111111011
001011111110111111110111111111111011111101111011111111111011
001011111101111111011111111111110111101111111111011111111011
001011110111111111110011111111111110111111111111111011111011
001011111111101111110111111011111111111111011111111101111011
001011110111011111111111011111011111111111101111111111111101
001011111011101111111111011111101111111111110111111111111101
001011011111111111111111111101111111101111110111011111111101
001011101111111111111101111111011111111111111110011111111101
