000000001000001001001000000001000001001011
000000001001001000001000000001001001000011
000000001000001001001000000001000001001101
000000001001001000001000000001001001000101
000000001000001001001000000001000001011001
000000001000001001001000000001000001101001
000000001000001001001000000001000011001001
000000001000001001001000000001000101001001
000000000000001001001000001001001001001001
000000000001000001001000001001001001001001
000000000001001000001000001001001001001001
000000001000001000001000001001001001001001
000000001000001001000000001001001001001001
000000001000000001001001000001001001001001
000000000001001000001001000001001001001001
000000001000001000001001000001001001001001
000000001001000001000001000001001001001001
000000001000001001001000000001001001001001
000000000001000001001001001000001001001001
000000000001001000001001001000001001001001
000000000001001001000001001000001001001001
000000001000001001001000001000001001001001
000000001001000001001000001000001001001001
000000001000001001001000000011000001001001
000000001000001001001000000101000001001001
000000001000001001000001001001000001001001
000000001000001001001000001001000001001001
000000001001001000001000001001000001001001
000000001000001001001000010001000001001001
000000001000001001001000100001000001001001
000000001000001001001001000001000001001001
000000001001000001001001000001000001001001
000000001000001001001010000001000001001001
000000001000001001001100000001000001001001
000000001000001001001001001000000001001001
000000001001000001000001001001001000001001
000000001000001001001001000001001000001001
000000001000001001001001001001000000001001
000000001000001001001000001001001001000001
