0000000101111001010101110010110010011
0000001000100111100010110100110101111
0000001001010100101110111001100001111
0000001100011011110001010110110010011
0000001101010000100010111110101100111
0000010010011111011100010101101000011
0000010110011001111101010001000010111
0000011001000010001111101110101001011
0000011001010001000010111111011000111
0000100001100100110010101110100101111
0000100011001000110110100110010101111
0000100011001010100111000011001011111
0000100011001011110010101010110100011
0000100011101111100100100110000101101
0000101001001111111010001000110001011
0000101010001001110010010010111110011
0000101101001001100010111110010100011
0000110101000101011011101001000100111
