000000000001000001010100010001010101
000000000001000101000100010101000101
000000000001010000010100010001010101
000000000100000001010001000101010101
000000000100000101000001000101010101
000000000100000101000101010001000101
000000000100000101010001000001010101
000000000100000101010100000101010001
000000000100010001000101000101000101
000000000100010001010001010000010101
000000000100010001010101000001010001
000000000100010100000001010101000101
000000000100010101000001000101000101
000000000101000000010001000101010101
000000000101000001000100000101010101
000000000101000001000100010001010101
000000000101000100000001010100010101
000000000101000100010001000101000101
000000000101000101000001000100010101
000000010000000101000100000101010101
000000010000000101000101000001010101
000000010000010000010001010100010101
000000010000010001000001010001010101
000000010000010001000101000001010101
000000010000010001010101010000000101
000000010000010100010000010101010001
000000010000010100010101010000000101
000000010000010101000001010001010001
000000010000010101010000010100010001
000000010000010101010001000001010001
000000010001000000010001001000110011
000000010001000000010001010001010101
000000010001000000010001100010011001
000000010001000000110001001000010011
000000010001000000110011001000010001
000000010001000001000101000101010001
000000010001000001010000010101010001
000000010001000001010001010000010101
000000010001000001010100000101000101
000000010001000001010100000101010001
000000010001000001010101010000010001
000000010001000010010001100000011001
000000010001000100000101000001010101
000000010001000101000100000101000101
000000010001000101010001000001000101
000000010001001000010001000000110011
000000010001001000010011000000110001
000000010001001000110001000000010011
000000010001010000000101010001010001
000000010001010000010001000001010101
000000010001010000010101000001010001
000000010001010001000001010000010101
000000010001010001010001000000010101
000000010001010100010000010000010101
000000010001100000010001000010011001
000000010100010001000001000001010101
000000010101000001000001000100010101
