0010111101110111110111111111111
0010111111011101111111111101111
0011010111111011111110111111111
0011011111010111101111111111111
0011111101101011101111111111111
