00001100110101001000100010111010111011001100111
00001100010100101010001110001111101111001001011
00001011000011100110111100100111101000100101011
00001010100011101100100100101101010010111110011
00001001101010001101111111000011001100100101101
00001000110010101011101000110100110110010101111
00001000110010101001110101110100011001010011111
00001000101111101010011111011000100001110011001
00001000011100010001001011101010011011010111111
00001000010101110111110011010010000110110001111
00001000010001101101111001010111111010010100011
00000101010011111010110000110011011010100100111
00000101010010101101111110100010110000111100011
00000100110110011001000011101101111101001001011
00000100100111110100010010101100001110011011111
00000011100100100010000011011111111011100001111
00000011001010101111011000110100101110101000111
00000010111100010010011000110101110011010101111
00000010110010000111100011100100110011011110111
00000010100100111001101001110111010011000111101
00000010100011010010011011100110011101010011111
00000010100011001111110100101001100011001011111
00000010010101010010100010101111111010110010111
