00000001010001010001010101010101
00000001010001010101000101010101
00000001010100010100010101010101
00000100000101010100010101010101
00000100010001010100010101010101
00000100010101000001010101010101
00000100010101000101010001010101
00000100010101010001010101000101
00000100010101010100010100010101
00000100010101010101010000010101
00000101000100010001010101010101
00000101000100010100010101010101
00000101000101000100010101010101
00000101000101010100010001010101
00000101000101010101000100010101
00000101010001010001000101010101
