00011111101010110100110110110010100111011101111111
00011110111001010010011011001010111110111111101111
00011110100111111101010010011100110111010111101111
00011101111011101001101100110010101100111011111111
00011101110110110111011110101001110010010111011111
00011101101111111011011010111001010101001001111111
00011101101001001101110010111110101010011111111111
00011101010111111010011010010101111111100110011111
00011100110100111111011101111111001001001010111111
00011011111010100100101110111111101111100100110111
00011011111001001100111110101011111011110110100111
00011011110111001011110010010111010101101111011111
00011011110101101001110111110111010100101100111111
00011011110101010010110011101111011111011100011111
00011011110010110011011101011111011111011010100111
00011011110010110011010101011111011111011110100111
00011011101101010010110010111111011111011100011111
00011011101010010010101111111011110001111001111111
00011011011101010010110011101111011111011100011111
00011011011100111111011111001001111011100101010111
00011011000110111111001111110101010010110111110111
00011010111111011111110110010101001010010011111111
00011010111111010111110111010101001010010011111111
00011010110011111101010010110111011100111111001111
00011010110011111101010010110111011100011111011111
00011010110011111101010010010111011100111111011111
00011010110011011101010010011111010110111111011111
00011010110010010101111111011011100101111011110111
00011010100111010010011111110111101110101011101111
00011001111110001101111110111101111100110101001011
00011001111011011001001010101011111110110110111111
00011001110100111111010010101111011101011111011011
00011001110100111010100101101111101110111101101111
00011001101110101001011001101111110110111110011111
00011001011111011111111010101100100110100111101111
00011001010111111101011111101001110110110110001111
00011001010111111101011111101001110110100110101111
00011001010111111101011111101001110110100110011111
00011001010111111011011010011101011111100011011111
00011001010111111011011010010101111110100111011111
00011001010111111011011010010101101111100111011111
00011001010111111010011010011101111111100110011111
00011001010111111010011010010101111111100111011111
00011001010111011011111010011101101111100101011111
00011001010111011010011010011101111111100111011111
00011001010110111111011111111001010010111110100111
00011001010110111101011111111001110110110110100111
00011001010101111101011111101001110110110110101111
00011001010011111101011111111001110110110110001111
00011001001111101010110111100110111011110011111011
00011001001101001111111010101100101111101111101111
00010111111111100011001111010110111011011010010111
00010111111111010110111101101011100111010101001011
00010111111111010110111101001011100111011001001111
00010111111110110110011101001011100111011101001111
00010111111100101100100111001111011111011101110011
00010111111100101100100111001111011011011101111011
00010111111001001010010101011101111111011111101011
00010111110011001001011101011110111111001110110111
00010111101110101100100101010011110101110111111111
00010111101110101100011001010100110111011111111111
00010111101100111111010101111110101100110110100111
00010111100100110111111011111001100110101101011111
00010111011111110011111101010011100011001111011011
00010111011110101101111111001011000111010011111101
00010111011101011000111010010111101111011011111101
00010111010111110111110111101001110001101111001011
00010111010110111110100111001111111010011101011011
00010111001110110101110111100100101011011111111101
00010111001110110101110111100011100011011111111101
00010111001110110101110110100101101011011111111101
00010111001110100101111011001011001111010111111111
00010111001110100101110111100011101011011111111101
00010111001110011010111011010100111111110111011101
00010111001011111001001011111110111011111001100111
00010111001010010110101111011101011001111011111111
00010110111111111101010111100111001001101001111011
00010110111101110111010111100111001001101001111111
00010110111011111011101010010110011111100011011111
00010110110111101111011101010101101001100110111111
00010110110010101111011100111111010111111001101101
00010110101011011111110111100111001101101101011101
00010110100010111011100111111101101101001110111111
00010110011111111100101111011000111010001111101111
00010110011101010010111011101110011100110111111111
00010110010111011110111000111111110111101101010011
00010110010111011100111010110111101101001111111101
00010110010110010011110111100111011111111110101011
00010110010011011100111010110111101101011111111101
00010101111111101110110011001111011101011010010111
00010101101111110101111111001100110100101111001111
00010101101110101100111001010100110111011111111111
00010101101110001111111101101110010110111110011101
00010101101100111110111001001111101011110101110111
00010101100111100111111110011001101111011011110101
00010101011000111110011111111101101001111101100111
00010101000110110111101111100101111110011110110111
00010100111111010011111100111100111101101110110101
00010100111101010111111011011101100110101001111111
00010100010111100110111111011011101101111001110111
00010100010111011110111111010110111001101001111111
00010011111111010110111101101011100111011101001101
00010011111110101111010111001101101101111101010011
00010011111110101100011111011111110101010010110111
00010011111110101100011110011111110101110010110111
00010011111110001110101111011011010111011001101111
00010011111110001100011111011111110101110010110111
00010011111100101110010111011111111101010010110111
00010011111011110001110110101111011101101101010111
00010011111010111110110011011100111101011111010011
00010011110101111011011110011111011110011010101101
00010011110101110011011110011111011110011010111101
00010011110101110011011100111111011110011010011111
00010011101111101001101111100111111110001011010111
00010011101111010111110101110011100110100110111111
00010011101101011101111000111010011011101011111111
00010011101011111110100110110111100011101101011111
00010011101001101100110101111110111101111110001111
00010011011111010111111100110110100110101111010111
00010011011111010111101111001001001101111010111111
00010011011110101111110010011010111101111100110111
00010011011110011110101111110011010111001001111111
00010011011110011110001010110101111111011101011111
00010011011110011010111101001111110101110111001111
00010011011110011010111101001011110101111111001111
00010011011110011010111101001011110101111101011111
00010011011110011010111101001011110101110111011111
00010011011110011010111100011011111101011101011111
00010011011110011010111100011011110101110111011111
00010011011110011000111101011010110101111111011111
00010011011110011000110101111010111101101111011111
00010011011011110111100110101111100010111101011111
00010011010111111110110111101011110011010001011111
00010011010101111011011110011111011110011010111101
00010011001111010111111101110111100110101011010111
00010011001111010111111100110111100110101111010111
00010011001111010111111100110110100110101111011111
00010011001111010111111100110101100110101111011111
00010011001111010111110101110111100110101110011111
00010011001111010011111101110111100110101111010111
00010011001101010111111101110101100110101011111111
00010011001001111100110101111010111111011110011111
00010011000111101011111011011100110111110101111101
00010011000111100011011011011100111111110101111111
00010010111111111111011110001110100110111000101111
00010010111111101110111110111001111001011100101011
00010010111111101110101110111001111001011100101111
00010010110101010111011110111101101111000111111011
00010010101111011111111001001111110011011011010111
00010010101111011110011001011111110011011111010111
00010010101110110010111110111101001111110011101111
00010010101101011110111001011111110011011111010111
00010010011111111111111000111100011111110001001111
00010010011111100110101111011111110101111000110111
00010010011111010101111111001001101101111011110111
00010010011110101111011100011011111010111110101111
00010010011110011001110010111111111101111101011101
00010010011110001001111111000111100011111111111111
00010010011011010111110101110111001110101101111111
00010010011010111111110101001101111011110101011111
00010010011010111101110111100101111001110101111111
00010010011010111101110111001101111001110101111111
00010010011010111101110110101101111001110101111111
00010010011010011111101000110111111101101111101111
00010001011110111110101101111100111101011101100111
00010001011100111111011011011011110111001110111101
00010001010111111011111010111101011011100011011111
00010001010110111101101111001111111100110110111101
00010001010110111101101011001111111100111110111101
00010001010100111101101111001111111100111110111101
00010001001111110101111111100011111001101011101111
00001111011011111111101000101110011101001011101111
00001111011011111111100110101010110100110011011111
00001111001100101110011011010101111110101101111111
00001110111110110100011011100011111110101101101111
00001110111110110100011010100110111110111101101111
00001110111100110100011010100110111110111101111111
00001110111010110100011010100110111110111101111111
00001110111001101101010101100111111111010110011111
00001110110001101101101111110011010101011111101111
00001110011110111001110111010110110011010101111111
00001110011000101011111011111111100101100110111111
00001110010011011001010111111111110011101011011111
00001101111110110001111110011010010101110111110111
00001101111101101110011101000101111111110110001111
00001101111011001010110111011010111100111110110111
00001101110110011110011111111010100110101011011111
00001101110101011111111011000110111111011011000111
00001101011111100010111110110101010111111101100111
00001101011011111111101000101110011101101011101111
00001101011001110010110110111011011111110101011111
00001101010111011000111010001111111110110111110111
00001100111101111111000111111011010101011101101011
00001100111101111111000101111011010111011101101011
00001100111010011111011011111010111110010101101111
00001100101011111010111111111100111010011101011011
00001100100101011111010111011111111010011100111111
00001100011111111101011010110111010101111110011011
00001100011101110011110110111010011111110101011111
00001100011101110010110110111011011111110101011111
00001100011101101111110101110110011010101101111111
00001100011101101111110101010110011110101101111111
00001100011101101111010101110110011110101101111111
00001100011101101111010101110110011011101101111111
00001100011101101111010100110111011110101101111111
00001100011100110011110110111011011111110101011111
00001100011001111010110110111011011111110101011111
00001100001101101111010101110111011110101101111111
00001011111111011010001111110101111111010101000111
00001011111110101010001111110101111111101101000111
00001011111101101100011101000110111111110111001111
00001011111100011101011100110100110111101111111101
00001011111001011111110110101101110111010011001111
00001011110111011010011101111101111111010101100011
00001011110111011010001111111101111101010101100111
00001011110111010110011100101010011011101111111111
00001011110110011010011111111101111111010001100111
00001011110110011010011111111101111101010101100111
00001011110110011010011111110101111111010101100111
00001011110101111111110011101110011100101111001011
00001011110011110111110110111001110010010111011111
00001011110011110111010110111001110100010111111111
00001011101111011001001111100101111011101111100111
00001011101110111100101111011100101111110111001011
00001011101101001111001101110110010111111111101011
00001011101101001101011111001100111111101110101111
00001011101100111001101011110100111100111111111011
00001011101100111001101010110101111100111111111011
00001011101100111001100011110101111100111111111011
00001011100111011010011111111101111101010101100111
00001011011111100111111101110101010010110011110111
00001011011111001010011101111101111111010111100011
00001011011110111101101011111011001110111110000111
00001011011110111001101011111011001110111110010111
00001011011110100101011110111011111011111011001011
00001011011110011111110001111111101110100110110011
00001011011011001011001101110011011111111101111101
00001011010101110100111110111100110011111111100111
00001011001111100101011110111011111011111011001011
00001011001111011011110010101011111110111001111101
00001011001101101111111010011110101111100011110111
00001011001100111010111010111011011100111111011111
00001011001010111111101101110110111101111011100011
00001010111110111110101111110100100011111111001101
00001010101110011101011011110110111111011110110011
00001010011110101100111111100011111011111111010011
00001001111111101010111110011101101011011111001011
00001001111111010101100110111011111111101010110011
00001001111110111101101011111001001110111110010111
00001000101101111111000111111011010111011101101111
00001000010111110110101110111110011011111110101111
00000111101101010110001100101101111111011111011111
00000111011001110101101101001111101011110111110111
00000111001101010111011010111101110010110111111111
00000110111111110111111001110010100010111001111111
00000110111111011011010111111011101101110110000111
00000110111111001010111101110111110011110110010111
00000110111101101110000101010111011110111101111111
00000110111001110101101111011010111111111010001111
00000110100111111101010110111101100111110111100111
00000110100111111101000110111101110111110111100111
00000110100111111101000110111101110110110111110111
00000110100010111111111010111111101101011100111011
00000110001111011111011101111011010101111111001011
00000101111101111101101111110010110001011101111011
00000101111101110111001011101111110111100100101111
00000101110011101100110111101010011111101111101111
00000101011011100011111111011001110101111111100111
00000101001111111101011110110111111110001110110101
00000100110110111001111111101011111010111001111011
00000100110001110111111101111111010011101011111101
00000100011101111010110110111011011111110101011111
00000100011101101111110101110111011110101100111111
00000011011110011010111101011011110101110111011111
00000010101111011010100111101111001111111101111101
00000010011111010110111101011101110101101110111111
00000001101111010111001101010111110111101110111111
00000001100111110011101001111101001111111101111111
00000000111011011111011011011101101101111011011111
00000000111011011011110110110111011011111011011111
