0000000000000110000100011
0000000000001010000100101
0000000000010010000101001
0000000000100010000110001
0000000001000000001100011
0000000001000000010100101
0000000001000000100101001
0000000001000001000110001
0000000001000010001000011
0000000001000010010000101
0000000001000010100001001
0000000001000011000010001
0000000001000100001000011
0000000001001000010000101
0000000010000010000100011
0000000010000010001100001
0000000010000100000100011
0000000100000010000100101
0000000100000010010100001
0000000100001000000100101
