0001001000111100110111100101010111101111111111
0001010110111110011011010100011001110111111111
0001011110111110010011010100011001110111111111
0001111001101011110100110110010100110111111111
0000110111100101010110001110101111100111111111
0000001101101111010101110001110110111011111111
0000101101100111010101110001110110111011111111
0000101101101111010100110001110110111011111111
0000110011110101101111010001010111011011111111
0001011110111100110001110100100111011011111111
0001011010111101110011100101110100011011111111
0000111100111100110110101000111011101011111111
0000001101011110011010011011010111111101111111
0001001011111110100011100010101011111101111111
0001100111010010101111010110110100111101111111
0000111001101101011101110101011000111101111111
0000111101101101011101110100011000111101111111
0000010110110111101010111000111011011101111111
0000011000111101000111101110111011101101111111
0000011000111101100011101110111011101101111111
0000011000111101100101101110111011101101111111
0000011000111101100111101110111010101101111111
0001010010110111011001101010011111110101111111
0001010010110111011001101010111011110101111111
0001010010110111011001101010111110110101111111
0000111101101101110101110101011010011001111111
0000110111111101111110111001010010010001111111
0000100110011110001101011111010011111110111111
0001110110011010001111101010010110111110111111
0001111001010010111011110011001011101110111111
0000111011001010111011111011110001001110111111
0000001010110011101110111110011110110110111111
0000001011110011101010111110011110110110111111
0000011010011110011101110010111111101010111111
0001000100110101011111111101111001101010111111
0001101111010100110111110111010100101100111111
0001101101100111110111010111010100101100111111
0000011011111101011111011101010100101100111111
0001101111100111110111010101010100101100111111
0001101101110110111110111010100101100100111111
0001101111110110110110111010100101100100111111
0001101111110110111110111010100100100100111111
0000110100101010111011111010111111011000111111
0000110111111101111110111001010010011000111111
0000001001101111001101011110101101111111011111
0001001100111001101010110101110101111111011111
0001001101101001101011010101111001111111011111
0000000111010011011101111010101111011111011111
0001001101111001101011110001110101011111011111
0001001011011001111011110011111001010111011111
0000101011110101111111010001100111011011011111
0001111001110110010100110111010111101011011111
0001001011011101011011110011111101010011011111
0001001101011110011010101101010111111101011111
0001001101011111001011110011011110101101011111
0001110111011100100100101111011111100101011111
0001001101011110011010111111010110111001011111
0000010101111001110011101101101101111110011111
0001010111111001100110101101001101111110011111
0000010100110111111111000111110110101110011111
0000110111111011011111011101010010110010011111
0000010101001010111111101110111001101111101111
0000100101100010111111101110111001101111101111
0001101110111111010011101100101001001111101111
0001001100110100111110101111110011010111101111
0001000101011011100101111110110111100111101111
0001010001011101011111101011011110110011101111
0001101111100110010100100111010111111101101111
0001011110101001100011011110011111011101101111
0001011111001001100011011110011111011101101111
