000011101000100110001011010010101000110111001111
000011011000101010001011010010011000111011001111
000011010111010110101010010001001110001000101111
000011000100100101010111100101000110111000011111
000010111011110001011010100100100101010001110011
000010110000110001111111000101101000100100111011
000010101001001100111000100010111100001101011111
000010101000110110001111010011101000100111001011
000010100110011101101011010010100010001100101111
000010100110001101101111010010100010011100101011
000010011111010100100101101010001100111110000101
000010011101010101100101101010001100111110000101
000010011100101100101111011010001101000010101011
000010011000111010001111010011011000101011001011
000010010110101000110111111100010100011000111001
000010010110011111000100101000110110001101110101
000010010110001111000100101000111110001101110101
000010010101100010101111101011010000110001110011
000010001111010101100101101110001100111010000101
000010001110010100100101101010011101111110000101
000010001100010100100101101010011101111111000101
000010000110101001101110010010001011010001111111
000001101011110100100011011010001010110010100111
000001100010111110100010010101100001110011011011
000001100010100011100100001101011111100010110111
000001100000110011110111110001101010010100011011
000001011110000100011010110101111100011100010011
000001011011011110110001001001011001010110010011
000001011000110010010101001010111110110000111101
000001011000110010010101000110111110110000111101
000001010111100000101111101110010101001001100011
000001001111010111011110100001001010000101110101
000001001110000110100001100111110111010100101011
000001001100110011111000101001010111100011010011
000001000100111101001101001001100110110101101101
000001000011000101011110000011101100110101011111
000000110111001001000001111100111111100001000111
000000110111001001000001111000111111100011000111
000000110111001001000001101101111111100010000111
000000110110111001101011010000110010101000101111
000000110101000111010011000010111101100101011011
000000110011111100011101001000010001110100011111
000000100111011101000110000110001111111000101101
000000100101100110110001001011001111100011011101
000000100101100011110101011010001111100011011001
000000100101100011110101011010001101100111011001
000000100011001010101111100001110100110010101111
000000100001001110001111111100000110011111001011
000000010111100001101011111010010101001001100111
000000010111010011111000100100101011110001110011
000000010011110100011111001000110001111100011101
000000010010100001110111111000010011110101011101

