0000000000011
0000000000101
0000000001001
0000000010001
0000000100001
0000001000001
