000000000000001001000000011000011001011
000000000000001001000000101000101001101
000000000000001001000010001010001011001
000000000000001001000100001100001101001
000000000000001001001000011000010001011
000000000000001001001000101000100001101
000000000000001001001010001010000011001
000000000000001001001100001100000101001
000000000000010010000000011000011010011
000000000000010010010000011000001010011
000000000000011000000000011001001001011
000000000000011000000000011010010010011
000000000000011000001000001011001000011
000000000000011000001001001010001000011
000000000000011000001010001001001000011
000000000000011000001011001000001000011
000000000000100000001110010000000111001
000000000000100000101010010000010101001
000000000000100011000001010001100000101
000000000000100100000000101000101100101
000000000000100100010000110010001000011
000000000000100100100000101000001100101
000000000000101000000000101001001001101
000000000000101000000000101100100100101
000000000000101000000100110100000010011
000000000000101000001000001101001000101
000000000000101000001001001100001000101
000000000000101000001100001001001000101
000000000000101000001101001000001000101
000000000000101000010000110100001000011
000000000001000001000010110000100001011
000000000001000001000100110000100010011
000000000001000001010001001010000001011
000000000001000001100001001100000001101
000000000001000011000001011000000011001
000000000001000100000010110010000001011
000000000001000101000001101000000101001
000000000001001000010001001010001000011
000000000001001000100001001100001000101
000000000001010000000000011001001001011
000000000001010000000001010010010010011
