0000000100011011
0000000100011101
0000000100100111
0000000100110101
0000000101000111
0000000101001101
0000000101010011
0000000101100011
0000000110001011
0000001000011011
0000001000100111
0000001000101011
0000001001000111
0000001001010011
0000001001100011
0000001010001011
0000001010010011
0000010000010111
0000010000100111
0000010000110101
0000010001000111
0000010001001101
0000010010001101
0000010010010101
0000010011000101
0000010100010011
0000010100100011
0000010101000011
0000100001001101
0000100010001011
0000100010001101
0000100010101001
0000100011001001
0000100100010011
0000100100010101
0000100101000101
0000100110000101
0000101000100011
