0001110110111111111
0010101111111011111
0010111011110111111
0010111110111110111
0010111111011101111
0011010111101111111
0011011010111111111
0011011111110101111
0011011111111010111
