0000000000000000000000000100010001111
0000000000010000000000100000000001111
0000000000000001000100000000000001111
0000000000000000000000000001001010111
0000000000000001001000000000000010111
0000000001000000001000000001000000111
0000000000000000000000000001001101011
0000000000000000011000000000000101011
0000000001000000000100000000010010011
0000000000010000000100000001000100011
0000000000000000010001000010000100011
0000000000010001000000010000000100011
0000000000010000001000010000010000011
0000000000001010000001000000010000011
0000000000000010000001000001100000011
0000000000000000011000000010100000011
0000000000100000000001000100100000011
0000000000001000000011000000100000011
0000000000010010000000010100000000011
0000000000010000000001101000000000011
0000000000010000011000001000000000011
0000000000000010000000100000001010101
0000000000000000001000001000100010101
0000000001000000000100000010000100101
0000000000000000001000001010001000101
0000000000000100001000000001010000101
0000000000000000100100001000010000101
0000000000100010000000010000010000101
0000000000100000000001000101000000101
0000000000010000001010000100000000101
0000000000000000100100000100000101001
0000000000000001000010010000000101001
0000000000010000000000010001001001001
0000000000100000000100001000001001001
0000000001000000001000001000001001001
0000000001000000100000010000001001001
0000000000000001000000101000010001001
0000000000000100100000010000010001001
0000000000100010000001000000010001001
0000000000001000000000010100100001001
0000000001000000001001000001000001001
0000000000000001000000001000100110001
0000000001000000001000000001000110001
0000000000000001000001000010000110001
0000000000100000010000001000100010001
0000000000010000100000000011000010001
0000000000100000100001000010000010001
0000000001000000011000010000000010001
0000000000001000000010000010100100001
0000000000010000000000100100100100001
0000000001000000100100001000000100001
0000000000100000001000011000001000001
0000000001000000000100000001110000001
0000000000000010000000010101010000001
