0000000000100001110100100111
0000000000101010000110110011
0000000000101100010110001011
0000000000110000101100110011
0000000000110001010010010111
0000000000110011001100001011
0000000001001011001100010101
0000000001001011100110000101
0000000001010100010101010101
0000000001011100010001010011
0000000001101000011000101011
0000000010000011001001010111
0000000010000011001010010111
0000000010000011101001010011
0000000010001101000110100011
0000000010010000100110011101
0000000010010000101110011001
0000000010010000110001011101
0000000010010001101000101011
0000000010011001100100001011
0000000010011001100100001101
0000000010100110100000101011
0000000010101001001001100011
0000000010110000001100110011
0000000010110011001100000011
0000000100000010110110100011
0000000100001101010001010011
0000000100010100010101010101
0000000100010100110100001011
0000000100010101010001010101
0000000100010110001011000101
0000000100011010111000001001
0000000100100000010101100111
0000000100100000111000110101
0000000100100001001111000101
0000000100100010001100010111
0000000100100010001100011011
0000000100100010001101010011
0000000100100010001110010011
0000000100100011010001010011
0000000100100110001100010011
0000000100101010001100010011
0000000100101011100010000011
0000000100110001001000100111
0000000100110001001010100011
0000000100110001011000100011
0000000100110101001000100011
0000000100111001001000100011
0000000101000001001001100111
0000000101000010001110001011
0000000101000100010101010101
0000000101000101000101010101
0000000101000101010001010101
0000000101001001000001010111
0000000101001101010001000011
0000000101010001010001010101
0000000101011100010000010011
0000000101100101010000100011
0000000110001000100100011011
0000001000001100001010001111
0000001000001100001010010111
0000001000001100010010001111
0000001000001100011010000111
0000001000001100011010001011
0000001000001100101010000111
0000001000001101000010101011
0000001000001101010010100011
0000001000010000011001010111
0000001000010001001100101011
0000001000010001001101100011
0000001000010001011100100011
0000001000010001101100100011
0000001000010010001100110101
0000001000010010001101110001
0000001000010010001110110001
0000001000010010100010110011
0000001000010010100010111001
0000001000010100010011001101
0000001000010100100010010111
0000001000010100100011010101
0000001000010100100110010101
0000001000010101011001000011
0000001000010110000011010101
0000001000010110010010001101
0000001000010110100010010101
0000001000010110100011000101
0000001000010111000100001101
0000001000011001010000011101
0000001000011010001100110001
0000001000011100001010001011
0000001000011100001010010011
0000001000011100010010001011
0000001000011100011010000011
0000001000011100100010010101
0000001000011100101010000011
0000001000100100000110001111
0000001000100100001011001101
0000001000100100001110001011
0000001000100110000011001101
0000001000100110000011101001
0000001000100110001010001101
0000001000100110001011001001
0000001000100111000011001001
0000001000101000001110110001
0000001000101000010110001011
0000001000101100000110001101
0000001000101100001010000111
0000001000101100001110001001
0000001000101100010010000111
0000001000101100010100001011
0000001000101100011010000011
0000001000101101000010100011
0000001000110000011010001101
0000001000110010000110010011
0000001000110010010100010011
0000001000110010100100010011
0000001000110011000100100101
0000001000110100000110001011
0000001000110100001011001001
0000001000110100010011000101
0000001000110100011000001101
0000001000110110000011001001
0000001000110110001010001001
0000001000110110010010000101
0000001000111100000110001001
0000001000111100001010000011
0000001000111100010010000011
0000001001000001010001101011
0000001001000010011001100101
0000001001000100000110010111
0000001001000100000110110011
0000001001000100001110010011
0000001001000101000010110011
0000001001000101000110010011
0000001001001100000110010101
0000001001001100001010000111
0000001001010001001100100011
0000001001010100000110010011
0000001001010100011001000011
0000001001010100100010000111
0000001001010100100011000101
0000001001010100100110000101
0000001001010110000011000101
0000001001010110100010000101
0000001001011100001010000011
0000001001011100100010000101
0000001001100110010000100101
0000001001110010000100010011
0000001010000010000110011011
0000001010000100000110101011
0000001010000100010010101011
0000001010000100010110100011
0000001010000100100010110011
0000001010001000001100011011
0000001010001001000110100011
0000001010001101000010001011
0000001010001101000100100011
0000001010001101010010000011
0000001010100100000110100011
0000001010100100010010100011
0000001010101101000010000011
0000001011000100000110010011
0000001011000100100010100011
0000001011000101000010010011
0000001100000100001100110011
0000001100001000001100110011
0000010000010100000100111011
0000010000010101000101010101
0000010000100001011100010011
0000010000100010011001000111
0000010000100011110100010001
0000010000100100010110001011
0000010000101000100100011011
0000010000101001000100101011
0000010000101001000110001011
0000010000101100010010001011
0000010000101100010100100011
0000010000101100010110001001
0000010001000001001000101111
0000010001000100000100101111
0000010001000100010101010101
0000010001000101000101010101
0000010001001000010100011011
0000010001001000010110010011
0000010001001010000110010011
0000010001001010100001101001
0000010001001110000101000011
0000010001010000010101010101
0000010001010000100111001001
0000010001010001010100010101
0000010001010100000100010111
0000010001010100000100011101
0000010001010100000100110101
0000010001010100000101010101
0000010001010100000110010101
0000010001010100001100010101
0000010001010100010001010101
0000010001010100010100010101
0000010001010100010101010001
0000010001010100100100010101
0000010001010101000100010101
0000010001010101000101000101
0000010001010101010000010101
0000010001010101010100000101
0000010001010110000100010101
0000010001100100001000100111
0000010001100110001001000011
0000010001101000010100010011
0000010001101000100100001011
0000010010000101000110100011
0000010010001000100001101011
0000010010001010000110100011
0000010010001100010100001011
0000010010001101000010100011
0000010010001101000101000011
0000010010001110000101000011
0000010010101001000100001011
0000010100001000100101010011
0000010100001101000100100011
0000010100001110000100010011
0000010100001110000100100011
0000010100010001000101010101
0000010100010001010101000101
0000010100010100010001010101
0000010100010101000100010101
0000010101000100010100010101
0000010101001000100101000011
0000011000100100001010001011
0000011000100100010100001011
0000011000101000010010001011
0000011000101001000100001011
0000011000110010000100010011
0000011001000100001010010011
0000011001000101000010010011
