0000000000000000101010000011001101101
0000000000000000110001001001001001111
0000000000000000111000100100100100111
0000000000000000111001001000010010111
0000000000000001100110100010100001011
0000000000000010100001101010001001011
0000000000000100000110110000101010011
0000000000000100001011101000100101001
0000000000000100011000001011011000101
0000000000000100100011000101000011011
0000000000000100100100001100010101011
0000000000000101000000110100001100111
0000000000000101001000100010011000111
0000000000000101100000000011100101011
0000000000001000010001001001100010111
0000000000001000011001010100000011011
0000000000001000100110100001001110001
0000000000001001000010011000011010101
0000000000001001001010001100000110011
0000000000001001100010001001011000011
0000000000001001101000011010000100011
0000000000001001101011000000101000011
0000000000001001110000101001000010011
0000000000001001110010000100100000111
0000000000001010000001100110000101101
0000000000001010000100011000101100101
0000000000001010000101100100001100011
0000000000001010100000010010110100011
0000000000001011001000010001010010011
0000000000001100001000001010110100011
0000000000010000001110000100100111001
0000000000010000010010001010000110111
0000000000010000010110000110000101011
0000000000010000100001000010101011101
0000000000010000100001100010110100011
0000000000010000101000100100100011011
0000000000010000101011100100001001001
0000000000010000110000101110010010001
0000000000010000110001001100000110101
0000000000010000110001010010010100011
0000000000010001000000100010100101111
0000000000010001000101001110000001011
0000000000010001010001010010000100111
0000000000010001010110000010110001001
0000000000010001011000000110001100101
0000000000010001100001110000001011001
0000000000010001100110100010100000101
0000000000010010100010100011000001101
0000000000010010101010111000000000011
0000000000010011000100000101110000101
0000000000010011010100000110100000011
0000000000010011100101000001001000101
0000000000010100000100100010000111011
0000000000010100001101000010001010011
0000000000010100101000001100100000111
0000000000010101010010000100110000011
0000000000010110011000001010000000111
0000000000011000000000011001010101011
0000000000011000010100011010000001011
0000000000100000010011000001010100111
0000000000100000010011010110010010001
0000000000100000100010100110010001101
0000000000100000100011011000100010101
0000000000100000100101001110100000101
0000000000100000101001000000101110011
0000000000100000101101100010001100001
0000000000100000110000000110011101001
0000000000100000110001010010000011011
0000000000100001000001111110000100001
0000000000100001010000010011000011101
0000000000100001010001001011000010101
0000000000100001010010010100011000011
0000000000100001101010001100010000011
0000000000100010000100001111100010001
0000000000100010000110001001000011011
0000000000100010001000001111000101001
0000000000100010001110000010010101001
0000000000100010101001010010000011001
0000000000100100000000110100011101001
0000000000100100001000001001100100111
0000000000100100001010100010000111001
0000000000100100011000010110000001011
0000000000100100011100110000000001101
0000000000100100100000100011010100011
0000000000100100100001000010100011101
0000000000100100100010000100111000101
0000000000100110000110001000000110101
0000000000100110101000100001010000011
0000000000101000000010001101001001011
0000000000101000000100100000111001101
0000000000101000000110010010010000111
0000000000101000001000110110001000101
0000000000101000110110100001000000011
0000000000101001000010001001110000011
0000000000101001000100010100010001101
0000000000101001000111010000001000011
0000000000101001100000001100010100011
0000000000110000000010001000101101011
0000000000110000000101011010100000011
0000000000110000100010000001000101111
0000000000110001010100000100010010011
0000000000110010000100010100001001011
0000000001000000010001001001101001011
0000000001000000011011000101000011001
0000000001000000100110101000110010001
0000000001000000100110101100000110001
0000000001000000110011000001011010001
0000000001000000110011100000001101001
0000000001000001000001111110001000001
0000000001000001000010000011111100001
0000000001000001001001010100000110101
0000000001000001001101010000100000111
0000000001000001010001001010000100111
0000000001000001011000100010011100001
0000000001000001100001000100101011001
0000000001000001110100001001001010001
0000000001000001110100100001100100001
0000000001000010001010000100100110101
0000000001000010011010100000011100001
0000000001000010100000011000010011011
0000000001000011000001011001000110001
0000000001000011001010000010110001001
0000000001000100000001000101001011011
0000000001000100110000010100101000101
0000000001000101000000001010110001101
0000000001000101000010000010010001111
0000000001000101001111000000010001001
0000000001000101110001000100001000011
0000000001001000000010000111010001101
0000000001001000000110000001101010101
0000000001001000010010001010000111001
0000000001001000010110001010000010011
0000000001001000100011000000101001011
0000000001001001000100110001000100011
0000000001001010101100100000001000011
0000000001001011001001100010000000101
0000000001001100000000010100001110101
0000000001010000001001000100011100101
0000000001010000010000100011001001101
0000000001010000100111001000001000011
0000000001010001000000001100001011011
0000000001010010010000011000100100011
0000000001011000100100001000101000011
0000000001011100010010000100010000011
0000000010000000010011000010100001111
0000000010000000100010010010001110101
0000000010000000101001000100111100001
0000000010000000101001100011000001101
0000000010000000101100011000001010011
0000000010000001000101000111000100101
0000000010000001001000010111010100001
0000000010000001010000110010010010101
0000000010000001010000110011101000001
0000000010000001010010111000100000011
0000000010000001011011010000000110001
0000000010000001011100100000001100101
0000000010000001100011000010010010101
0000000010000001101011000001000100011
0000000010000010011010110000001000101
0000000010000010011100010010001100001
0000000010000010101000110010010000011
0000000010000100000101110101000100001
0000000010000100000110000011001010011
0000000010000100001000001001011001101
0000000010000100010000110100000101011
0000000010000100010101110000010100001
0000000010000100100000110000100010111
0000000010000100100101000000001011101
0000000010000100100101010000001011001
0000000010000101001000110000110001001
0000000010000110000001001111000000101
0000000010000110001000000110000010111
0000000010000110001001000100000101101
0000000010001000000010100001011001011
0000000010001000001000000100100101111
0000000010001000010100010000110100011
0000000010001001010000000011010010011
0000000010001001011000000001010010011
0000000010001010100000110000100001011
0000000010001011100000010010000101001
0000000010001101010001001000010000011
0000000010010000000100000110001011011
0000000010010000110001100000010001011
0000000010010001010000000011100010011
0000000010010001010100010011000000011
0000000010010100010100100000010001011
0000000010010100011011000000100000101
0000000010010110001000001000010001101
0000000010100000010010000001100011101
0000000010100000010010000100011001101
0000000010100000101000000100010110011
0000000010100000110000100000100110011
0000000010100000111010001000000100011
0000000010100001110001010000000100011
0000000010100011000001000100100001011
0000000010100100001001000001100001101
0000000010100100010000001000001010111
0000000010100111010000010000100000011
0000000010110110001000000010100000011
0000000011000000100001010001010010011
0000000011000100000010000010101001011
0000000100000001000001010010001101011
0000000100000001000010100010001011011
0000000100000001001001010100001000111
0000000100000010001011001010000100011
0000000100000010001110010010000001011
0000000100000010010100110000000111001
0000000100000010010110100010001100001
0000000100000010011101000101001000001
0000000100000010100010110010000110001
0000000100000010100111000000011001001
0000000100000011110100010010000100001
0000000100000100000100000100000111111
0000000100000100000100100001010011011
0000000100000100010110000010110100001
0000000100000100100000011100010100101
0000000100000101110010000010010100001
0000000100000110000001010010000011101
0000000100000110001000001011100100001
0000000100000110010000001010101001001
0000000100000110010000011000101010001
0000000100000111000010000000100111001
0000000100001000011101000001100010001
0000000100001000100001000000111110001
0000000100001001010000001001101000101
0000000100001010001000011001001000101
0000000100001100000010101000011001001
0000000100001100001010110000010010001
0000000100001100010010001000000010111
0000000100001100110100000010100010001
0000000100001110100010100100000010001
0000000100010000001011000011000101001
0000000100010000001100100001110001001
0000000100010000100110110000010000101
0000000100010010000000111001001010001
0000000100010010000010010000011100101
0000000100010110010000001101000000101
0000000100010110010100001000100000011
0000000100010111000001000010000010011
0000000100011010000001011000100000011
0000000100011100100100010010000000101
0000000100100000010000001011100011001
0000000100100000100010110001100000101
0000000100100001000010000010010110011
0000000100100001000110000010000011101
0000000100111000100001010000001000101
0000000101000000100101000010011000011
0000000101000001001010010000110000011
0000000101000001100001000000100011011
0000000101000010000001000100001101101
0000000101000101000010011000000100011
0000000101000101000010011000100000011
0000000101000110010100000010001000011
0000000101001000000101000010011000011
0000000101001000001100101000100000011
0000000101100100001000100000101000011
0000000110001000010000001010100010011
0000000110001000101000010000001001011
0000000110100010100001000000100000111
0000001000000100000010000001001111101
0000001000000100000010000001011110011
0000001000000100000010000111001100101
0000001000000100000010111010000010011
0000001000000100000110110000101100001
0000001000000100001001001110001000101
0000001000000100001010010010000010111
0000001000000100001101100000100110001
0000001000000100010001001001001011001
0000001000000100100001000010001010111
0000001000000100100010011000100011001
0000001000000100100011000011000100101
0000001000000101010000010001001010011
0000001000000101100001000000100001111
0000001000000101100001000000100010111
0000001000000110100000100001001001011
0000001000001000001000001000001011111
0000001000001000001010000100100010111
0000001000001000001110001000001000111
0000001000001000010000100101000100111
0000001000001000100000011101100001001
0000001000001000100100000010000110111
0000001000001000101001000000100110011
0000001000001001010001011000010001001
0000001000001011000001000000110101001
0000001000001100001000001001101000011
0000001000001100001010001000101000011
0000001000010000001000010010101010101
0000001000010000010000100010010010111
0000001000010000010001000000111100101
0000001000010000010001000001100100111
0000001000010000100001000010101010101
0000001000010001000100000110001100101
0000001000010100010001010010010000101
0000001000010110100000011000001010001
0000001000100000010001000010000101111
0000001000100000010110000100000100111
0000001000100000100000110010000001111
0000001000100000100001110010000001011
0000001000100001000001011100000011001
0000001000100010100100100001000001011
0000001000100100100000110001000010011
0000001000100101000001000010100100011
0000001000100101000010000010100100011
0000001000101001000010010100010000101
0000001001000100010000100000100101101
0000001001100001000001000001010010101
0000001010100011001000010000010000011
0000001100100000100001000110000010011
