0000000000010010111
0000000000010100111
0000000000011001011
0000000000100011011
0000000000100100111
0000000000100110101
0000000000101000111
0000000000101001101
0000000000101010011
0000000000101100011
0000000000110001011
0000000001000010111
0000000001000100111
0000000001000101011
0000000001000101101
0000000001000110101
0000000001000111001
0000000001001010011
0000000001001100101
0000000001010000111
0000000001100001011
0000000001100010011
0000000010000011011
0000000010000011101
0000000010000101011
0000000010000111001
0000000010001000111
0000000010001001011
0000000010001001101
0000000010001011001
0000000010001100101
0000000010010001101
0000000010010100011
0000000010011000011
0000000010100001011
0000000010100001101
0000000010100100011
0000000010101000011
0000000010110000011
0000000100000011011
0000000100000011101
0000000100000100111
0000000100000101011
0000000100000101101
0000000100000110011
0000000100001001011
0000000100001011001
0000000100001100101
0000000100010000111
0000000100010001011
0000000100010010011
0000000100010010101
0000000100010100011
0000000100010100101
0000000100011000011
0000000100100000111
0000000100100100011
0000000100101000011
0000000100101000101
0000000101000100011
0000000101000100101
0000000101001000011
0000000101010000011
0000001000000101011
0000001000001000111
0000001000001001011
0000001000001001101
0000001000001010011
0000001000001100101
0000001000001110001
0000001000010000111
0000001000010010011
0000001000010010101
0000001000100001011
0000001000100100101
0000001000100101001
0000001000101000011
0000001000101001001
0000001000110000101
0000001000110001001
0000001001000001011
0000001001000100011
0000001001000101001
0000001001100000101
0000001010000010011
0000001010010000011
0000010000010010101
0000010000100001011
0000010000100010011
0000010000100011001
0000010000100100011
0000010000100110001
0000010000101001001
0000010000101010001
0000010000101100001
0000010000110001001
0000010001000001011
0000010001000010011
0000010001000010101
0000010001000100101
0000010001001000011
0000010001001000101
0000010001010000101
0000010001100000101
0000010001100001001
0000010010000101001
0000010010001000011
0000010010001000101
