00000001011101111
00000001101011111
00000001101101111
00000010110011111
00000010110110111
00000010111001111
00000010111100111
00000010111110011
00000011010111011
00000011011010111
00000100011011111
00000100101011111
00000100101110111
00000100110101111
00000100110111101
00000100111001111
00000100111010111
00000100111100111
00000101010110111
00000101011010111
00000101011011011
00000101011011101
00000101011100111
00000101011101101
00000101100011111
00000101100111101
00000101101010111
00000101101100111
00000101101110011
00000101110010111
00000101110011011
00000101110011101
00000101111010011
00000110001101111
00000110001111011
00000110010101111
00000110011010111
00000110100111011
00000110101001111
00000110101011011
00000110101100111
00000110110100111
00001000101101111
00001000110011111
00001000110101111
00001000111011011
00001000111110011
00001000111110101
00001001001110111
00001001010011111
00001001010110111
00001001011011101
00001001011101011
00001001011111001
00001001100101111
00001001101010111
00001001101101011
00001001101110101
00001001110010111
00001001110011101
00001001110100111
00001001110101011
00001001110101101
00001001111001101
00001001111010011
00001010001101111
00001010001111011
00001010001111101
00001010010011111
00001010010111011
00001010011001111
00001010011011101
00001010011110011
00001010100111011
00001010101011011
00001010101101011
00001010101101101
00001010110010111
00001010110011011
00001010110110011
00001010111001011
00001010111001101
00001011000110111
00001011000111011
00001011001010111
00001011001011101
00001011001100111
00001011001101011
00001011010011011
00001011010101011
00001011010110011
00001011011001011
00001011011010011
00001011011100011
00001011100110011
00001011101001011
00001011101100011
00001011110001011
00001011111000011
00001100010011111
00001100010101111
00001100010111011
00001100100011111
00001100101001111
00001100101010111
00001100101011011
00001101000110111
00001101000111011
00001101010011011
00001101100010111
00010001001011111
00010001001101111
00010001010011111
00010001010101111
00010001011010111
00010001011011011
00010001011101011
00010001100101111
00010001101001111
00010001101011011
00010001101100111
00010010001101111
00010010010011111
00010010010101111
00010010010110111
00010010010111011
00010010010111101
00010010011010111
00010010011110101
00010010100011111
00010010100111101
00010010101001111
00010010101100111
00010010101110011
00010010101111001
00010010110010111
00010010110011011
00010010110011101
00010010110101011
00010010111000111
00010010111010011
00010010111100011
00010011000111101
00010011001111001
00010011010001111
00010011010011101
00010011010100111
00010011010101011
00010011010101101
00010011010110101
00010011011000111
00010011011010011
00010011011100011
00010011011100101
00010011101001011
00010011101001101
00010011101010011
00010011101100101
00010011110001101
00010011110010011
00010011110010101
00010011110100101
00010100010101111
00010100010110111
00010100100110111
00010100101011101
00010100110001111
00010100110010111
00010100110011011
00010100110011101
00010100110101011
00010100110110011
00010100111001101
00010100111100011
00010101001001111
00010101001100111
00010101001101011
00010101001110101
00010101100100111
00010101101000111
00010101110001101
00010110001101101
00010110010100111
00010110100100111
00010110100110011
00010110110010011
00010110110100011
00010111001010011
00010111010010011
00011001001010111
00011001010010111
00011001010100111
00011010010101011
00011010100100111
