000000000100000000010000000111
000000000100000000100000000111
000000000100001000000000100011
000000000100000000010001000011
000000000010000000110000000011
000000000100000000110000000011
000000000100000001010000000011
000000000000000100000100010101
000000000000010000010000010101
000000000100000000010000010101
000000000000010001000000010101
000000000001000001000000010101
000000000100000001000000010101
000000000100001000000000100101
000000000000010000000101000101
000000000001000000000101000101
000000000000010000010001000101
000000000001000000010001000101
000000000100000000010001000101
000000000000000101000001000101
000000000000010001000001000101
000000000100000001000001000101
000000000100000100000001000101
000000000100000000010010000101
000000000001000001000100000101
000000000001000100000100000101
000000000100010000000100000101
000000000100000000110000000101
000000000001000001010000000101
000000000100000001010000000101
000000000001000100010000000101
000000000100000100010000000101
000000000100010000010000000101
000000000100000000010001001001
000000000100000010000001001001
000000000000100010010000001001
000000000100000010010000001001
000000000100010000010000001001
000000000000000100000101010001
000000000001000000000101010001
000000000001000000010001010001
000000000000010001000001010001
000000000100000001000001010001
000000000000100000010010010001
000000000000010000010100010001
000000000100000100000100010001
000000000001000001010000010001
000000000100000001010000010001
000000000100000100010000010001
000000000100001000000001100001
000000000100001000000010100001
000000000100001000000100100001
000000000100001000001000100001
000000000100001000010000100001
000000000001000000010101000001
000000000100000001000101000001
000000000100000000110001000001
000000000100000001010001000001
000000000100000010010001000001
000000000100000001010010000001
000000000010000000011100000001
