000000001011
000000010011
000000100101
000001000011
000001000101
000001001001
000010001001
