000000001001110010111
000000001011100101011
000000001100011011011
000000001100101010111
000000010001110100111
000000010010011010111
000000010010011110101
000000010010110010111
000000010011101001101
000000010100011011011
000000010110011001011
000000010111100010011
000000011000011011011
000000011001011001011
000000011010001101011
000000100100101100111
000000100100101110011
000000100101000110111
000000100110001011101
000000100110100111001
000000100110101001101
000000101000101001111
000000101000101100111
000000101000101101101
000000101001001110101
000000101001101001101
000000101110101000011
000000110000101001111
000000110000101011011
000001000010010110111
000001000100110110101
000001000101011000111
000001000111000011101
000001000111000101011
000001000111001001011
000001000111010010101
000001001000011011011
000001001000101101101
000001001001000111011
000001001001000111101
000001001001010011011
000001001001010110011
000001001001100101101
000001001001100110101
000001001010011001101
000001001010011011001
000001001011010011001
000001001101011000101
000001001110010001101
000001010000011001111
000001010001001011011
000001010001001101011
000001010010001101011
000001010010010110011
000001010010011000111
000001010010011001011
000001010010011010011
000001010011001001011
000001010011010010011
000001010101001100011
000001011001001010011
000001011001010010011
000001011011001000011
000001100100001010111
000010000100001011111
000010000100011111001
000010000100101011101
000010000100101110101
000010001000010101111
000010001000010111011
000010001000100011111
000010001000111001011
000010001000111100101
000010001000111110001
000010001001011001011
000010001001011010011
000010001010010010111
000010001010010011011
000010001010010011101
000010001010011011001
000010001010100101011
000010001010110000111
000010001011001001011
000010001011001011001
000010001011010010011
000010001011100100011
000010001100100001111
000010001100101010011
000010001100101110001
000010001101100100011
000010001110100001011
000010001110100010011
000010001111100001001
000010010000101011101
000010010010001011011
000010010100010011011
000010010100010011101
000010011000010110101
000010011010000101011
000010011010001001011
000010011010010001011
000010100011100010011
000011010010001000111
