00000010101010001010000010000101010001000101000011
00000010101010000010000010000101010001000111000011
00000010100010001010000010000101010101000101000011
00000010011010010000011010001001001000001000100101
00000010010101010000100000100001001010101000010101
00000010010100010010011010010001001000001000001101
00000010010100010000011010010001001000001001001101
00000010010010010010001011010001000011001000000101
00000010010000010010111010010001000010001000001101
00000010010000010010011010010001001010001000001101
00000010010000010000011010010001001010001001001101
00000010001010100010000010000101000001010101000111
00000010001001100110010010000001001100010001001001
00000010001001100010010010000001001100010011001001
00000010001001000010101010010100010000100001010101
00000010001000100110010010000001001100110001001001
00000010001000100010010010000001001100110011001001
00000010001000100010010000001001100110011001001001
00000010001000010101010010010100010000001010101001
00000010001000010101010010000100010100001010101001
00000010000011100010101010100001100001000001000101
00000010000011001111000010000011000000100011000011
00000010000011001000110011000001001001000110010001
00000010000011000011100110000011000000100001110001
00000010000011000011100010000011000000100001110011
00000010000011000010100010000011000000100101110011
00000010000010100010101010100001100001010001000101
00000010000010100010001110000101000101010101000001
00000010000010100010001010100001100001010001010101
00000010000010001000100011000001001001100110011001
00000010000001000011100110000011000001100001110001
00000010000001000011100010000011000001100001110011
00000010000001000010100110000011000001100101110001
00000010000001000001100011000001100000110001111001
00000001010010010110000110100000100001001001000011
00000001010010010010000110100000100001001011000011
00000001001001010000001110000110100100001000001011
00000001001000011000001010000110100100101100001001
00000001000110001000110110000000110011000100000011
00000001000110001000100110000000110011000100001011
00000001000110001000010110000000110011000100010011
00000001000110001000000110000000110011000100011011
00000001000010010110000110100000101001001001000011
00000001000010010010000111100000101001001010000011
00000001000010010010000110100000101001001011000011
00000001000001010010000110000110100001001001001011
00000001000000101100011110000000100000011000001111
00000001000000101000011110000000100000011010001111
00000001000000100100011110000000100000011100001111
00000001000000100000011110001111000000010000001111
00000001000000100000011110000000100000011110001111
00000001000000010110011110000000100000010100001111
00000000110100001000110001000000011001000100011011
00000000110010001000110001000000011010000100011011
00000000101100010001000110000001100110001000010011
00000000101100010000100110000001100110001000100011
00000000100101010100001000101000010010101010000101
00000000100010010111000010001010010000001011001001
00000000100000011110000101100000010000001111000101
00000000011010000010101100000000101001000000011111
00000000010110100000101111000000001001000000010111
00000000010110000000101111000000001001010000010111
00000000010110000000100111001000001001010000010111
00000000010010100000101111000000001011000000010111
00000000010010100000100111001000001011000000010111
00000000010010001001100010010001001001001100010011
00000000010010000000101111000000001011010000010111
00000000001101000000011111000000010100100000101011
00000000001000010101010010000101010100001010101001
00000000001000010101010000101010100100001010101001
00000000001000000011110001111000000100000001111001
00000000000100100101100000010000000010011011111001
00000000000010010010101010000101010100001001010101
00000000000000100110111100010000000000010011010111
00000000000000100110101100010000000000010011011111
00000000000000100101110100010000000000011011110011
00000000000000100100111100010010000000010011010111
00000000000000010011011111001000000000001001101011
00000000000000010011010111001000000000001001101111
00000000000000010011010110000000000010011011111001
