0011001111110101111101111111111111111
0011011110111101011101111111111111111
0011111101101101011101111111111111111
0001110111101101111110111111111111111
0001011111011110111111011111111111111
0011011110101111101111101111111111111
0011011111010111101111101111111111111
0011111101110111110110101111111111111
0011010111111011011111110111111111111
0010111101110111110111110111111111111
0011010101111110111111111011111111111
0010110111011111101111111011111111111
0010111011110111101111111011111111111
0011111111011101101011111011111111111
0001111011011111111110111011111111111
0001101111101111111011111101111111111
0011111010110111111111011101111111111
0011110101011111111111101101111111111
0011111101110101101111111110111111111
0011101011111111101101111111011111111
0011111010110111111111110111011111111
0011011111011110101111111111101111111
0001101111110111111111101111101111111
0010111011111111111011110111101111111
0010101111111111111111011111001111111
0011111011101011011111111111110111111
0010111110111101110111111111110111111
0010101111111101111101111111110111111
0011011111011111111111101011110111111
0010110111111111111110111101110111111
0011010111111111111101111111011011111
0011101111110110111111111111101011111
0011101111111111111011011111101011111
0011101101111111101011111111111101111
0010111101110111111111011111111101111
0011011111111110111111101011111101111
0010111111111110111110111111011101111
0010111111110111011111111111110101111
0011011011111101011111111111111110111
0011011111111111110111111010111110111
0011011111111010111111111111111010111
0010111111110111101111111111110111011
