00000000000000000000010000100001000011111
00000000010000000010000000010000000011111
00000000100000001000000010000000100001111
00000000000001000000000010001001001001011
00000000010100001000000010000000010001011
00000000001000010010001000010000000001011
00000000000000000000000010001100101010011
00000000000000000011000010001000100010011
00000000000001000011100000000001000010011
00000000000010100100100000010000000010011
00000000001011000000001000100000001000011
00000000010000000011100001000000001000011
00000000010000001100000100001000010000011
00000000010000001001000010000100100000011
00000000010001000001001000000101000000011
00000000001000110000000001010100000000011
00000000000010001001001001100000000000011
00000000000000100001000000000000101011101
00000000100000000100000010000000011010101
00000000010000000001000000000100101010101
00000000000001000000000000110100100100101
00000000100000000100000000100011001000101
00000000100000001000001000011000001000101
00000000000010001000001001001000001000101
00000000100000001010000010001000100000101
00000000000010000000100001110000100000101
00000000001000100010010000000101000000101
00000000100001000001000000110010000000101
00000000100000001100000010000000010011001
00000000000000010010011000000100000011001
00000000010000001000000000100001011001001
00000000100000100000100001000100100001001
00000000010000001010010100000010000001001
00000000000100000000100001010010000110001
00000000000010000100101000001000000110001
00000000001000000001010001100000010010001
00000000100001000010000100001000100010001
00000000100000000100000000100000111100001
00000000000010000100000010101010000100001
00000000000010000001001000101000011000001
