0000000000000000000000010111
0000000000000000000000100111
0000000000000100000000000111
0000000000000000000010001011
0000000000000010000000001011
0000000000001000000000001011
0000000000000000000010100011
0000000000000000010001000011
0000000000100000000001000011
0000000000001000000010000011
0000000000100000000010000011
0000000000000000010100000011
0000000000000100000100000011
0000000001000000001000000011
0000000000000010100000000011
0000000000000101000000000011
0000000000001010000000000011
0000000000000000000100010101
0000000000000000010000010101
0000000000000100000000010101
0000000000001000000000010101
0000000000000001000001000101
0000000000000010000001000101
0000000000000100000001000101
0000000000010000000001000101
0000000000000000010010000101
0000000000010000000010000101
0000000000000000100100000101
0000000000000001000100000101
0000000000000100000100000101
0000000000010000000100000101
0000000001000000000100000101
0000000000000100001000000101
0000000000000100010000000101
0000000000010000010000000101
0000000001000000010000000101
0000000000001000100000000101
0000000000010001000000000101
0000000000000000100000101001
0000000000000001000001001001
0000000000000100000001001001
0000000000001000000001001001
0000000000100000000010001001
0000000000000010000100001001
0000000000000100000100001001
0000000000100000001000001001
0000000000000100010000001001
0000000000010000010000001001
0000000000100000100000001001
0000000000000100000000110001
0000000000000010000001010001
0000000000000100000001010001
0000000000000100000100010001
0000000000010000000100010001
0000000000000100001000010001
0000000001000000001000010001
0000000000010000010000010001
0000000001000000010000010001
0000000001000001000000010001
0000000001000010000000010001
0000000000001000000010100001
0000000000001000001000100001
0000000001000000010000100001
0000000000100000100000100001
0000000000010000001001000001
0000000001000000100001000001
0000000000100000001010000001
0000000001000000001100000001
