001110111111111111111111111011111101101111101011111111111
001110101111111110111111111111111110110111111111101111111
001111101111111111101110111111111111111111110110101111111
001101111011111111110101111111111101111111111111111011111
001101111111010111111111111111011111101111111111111101111
001011111111101111111111111111110111011111101111111101111
