0000000000000000000010111
0000000000000000000100111
0000000000000000010100011
0000000000000000100010101
0000000000000001000010011
0000000000000010000010101
0000000000000010001000011
0000000000000010010000101
0000000000000100000100011
0000000000000100000100101
0000000000000100100000011
0000000000001000000001101
0000000000001000000100101
0000000000001000001001001
0000000000001000001100001
0000000000010000000000111
0000000000010000000101001
0000000000010000010000011
0000000000010000010001001
0000000000010000100010001
0000000000010100000000011
0000000000100000000110001
0000000000100000001000011
0000000000100000001001001
0000000000100000010001001
0000000000100000010010001
0000000000100000100001001
0000000000100010000000101
0000000001000000001000011
0000000001000000001001001
0000000001000000010000101
0000000001000000100001001
0000000001000000101000001
0000000001000001000010001
0000000001000010000100001
0000000010000000010000101
0000000010000000100000011
0000000010000000100010001
0000000010000000110000001
0000000010000001000000101
0000000010000100000010001
