00000000000000000000000000010000100001000011111
00000000000001000000000001000010000000000011111
00000000000000000000000000000000000100110101111
00000000000000000001001100000000000000000101111
00000000010000000001000000001000000001000001111
00000000010000000010000000001000000001000001111
00000000000100100000000001000100000000010000111
00000000001000000000010000000000100110000000111
00000000000100000000001100000000010100000000111
00000000000000000000000000000010001001001101011
00000000001000000001000000001000000000010101011
00000000000000100010000000000010000001001001011
00000000000000100010010000000010000000001001011
00000000001000000001000000001001000001000001011
00000000001001000000001000001000001000000001011
00000000000000000000000000000010001100101010011
00000000000000001000011100000000000001000010011
00000000000000100000001100001000010000000010011
00000000001000000100001000001000000000010100011
00000000000000000001100000000100010001000100011
00000000000000100000100001000010000100000100011
00000000000010110000000000100010000000001000011
00000000000000100000000001000110000100010000011
00000000000001000010000000010000110000010000011
00000000000000100000010000010010010000010000011
00000000000000100000001001000010100000010000011
00000000000100000001000001100000100000010000011
00000000000000010000001100000011000000010000011
00000000001010000000001001000000001000100000011
00000000000000001010000000110000000011000000011
00000000001000000000010010000100000101000000011
00000000000100000100000010000001100001000000011
00000000000000010000011100000010000010000000011
00000000010000000010001100010000000010000000011
00000000000000101000000000000011110000000000011
00000000000010001100000000000101010000000000011
00000000000000000100001000000000000000101011101
00000000000000000000000001000010000100001011101
00000000000000000010010010100000000000000011101
00000000000000100000000000000100001001001001101
00000000000000000000010010000100001000010001101
00000000010000000001000000000100000000101010101
00000000001000000001000000001000000001001010101
00000000000000000000000010000010100010001010101
00000000000000101000000000010001000000001010101
00000000000010000000100000001000000010010100101
00000000000000010000000000100001010010000100101
00000000000001000000010010010000100000000100101
00000000001000000000010000000000100010011000101
00000000000000100000000000001100001001001000101
00000000000000100000001000001000001010001000101
00000000000100001000000001000000100001010000101
00000000000000000101000000101000000100010000101
00000000000001000010000110000000000100010000101
00000000000001001010000000010000001000010000101
00000000000100100001000000000101000000010000101
00000000000000100000001010000010001000100000101
00000000000010010000000001100000010000100000101
00000000000100001000001000000010001001000000101
00000000010000000010100000010000100001000000101
00000000000000100000000100000111000001000000101
00000000000010001000100001000000010100000000101
00000000000001000010000110001000000100000000101
00000000001000100000001000011000001000000000101
00000000000100000001000000110000000000010011001
00000000000000000010010000100000101000000011001
00000000000010000001100000000001010000000011001
00000000000001000011000000010000100000000011001
00000000001000000000010000000000100001010101001
00000000000000100000100001000000110000000101001
00000000000010000001000000000100000001011001001
00000000010000000001000000000100000001011001001
00000000001000000010000000100000001001001001001
00000000000001000000001001000001000001001001001
00000000000010000000010010000001000001001001001
00000000010000001000000100000010000001001001001
00000000000000000010010000001000100010001001001
00000000000010000000000001000001100001010001001
00000000000100010000000100000001000100010001001
00000000000001001000000100000100010010000001001
00000000010000001000010010000100000010000001001
00000000001000010010010000000100000100000001001
00000000000001000000010110001000010000000001001
00000000000010000110000000000100000000001110001
00000000000010000000100000000100010001000110001
00000000000000010000100011000000010000000110001
00000000010000000001000000000100001000101010001
00000000001000000010000001010000000001001010001
00000000000010000000001000001100001000001010001
00000000000010000001000000000010001000110010001
00000000001000000000010000001000001000110010001
00000000000100000000001100100000001000010010001
00000000000010001000000100000100100000010010001
00000000000010000001000001001000000001100010001
00000000000010000001000001001100000001000010001
00000000000000001000011110000000000001000010001
00000000000000100000010010001000000110000010001
00000000010000001000100000100001000010000010001
00000000000001000000010010001001000100000010001
00000000000100000000001100000100000100001100001
00000000010000000001000010000001000010010100001
00000000000010000001000000000010100100010100001
00000000000010000000100001001000000010100100001
00000000000001000010000100011000000001000100001
00000000000001000000001000100001000110000100001
00000000000010000001000000001000101000011000001
00000000010000000010000000010000011001001000001
00000000001000000010000101010000000001001000001
00000000000010000001001000000010001000110000001
00000000000000100000001001000010100000110000001
00000000010000000101100000000100000000110000001
00000000001000000010001001000000101000010000001
00000000001000000011110000001000000000010000001
00000000000010000000000001000000001111100000001
00000000000010000000000101010101000010000000001
