00000001011100101100100111001010111011
00000010100100101111101111000100011011
00000100001011111001010111001101001011
00000101010001101100100101111011100011
00000110000101101010001110111110010011
00000110010100010000101111110011001111
00001000010011111000110110010110011101
00001000101111100001101010010101100111
00001000110010101101100101001110100111
