0000001010001010001101001011100110010101111111
0000001011001010001101000011100110010101111111
0000001110011001010110000010111010010111001111
0000010110010111000110111010100001001011001111
0000000101101100011010100011000011101101110111
0000001101001100011010100011000011101101110111
0000001101101100011010000011000011101101110111
0000001101101100011010100011000001101101110111
0000001101101100011010100011000010101101110111
0000000101110010011100101100101010110001110111
0000000101110010111100001100101010110001110111
0000000101110010111100100100101010110001110111
0000000101110010111100101100001010110001110111
0000000101110010111100101100101010010001110111
0000111000101001000100100011010111110110010111
0000000101110010111100100100101010110011100111
0000000110110101001001000100101111101101100111
0000000101101100011010101011000011101101100111
0000101100010000110100010011111110101001100111
0000101100010100110100010010111110101001100111
0000101100010100110100010011101110101001100111
0000101100010100110100010011111110100001100111
0000001011010011010001110101100010011110100111
0000110110011001111010110001001010100101000111
0000110110011011011010110001001010100101000111
0000110110011011110010110001001010100101000111
0000110110011011111000110001001010100101000111
0000110110011011111010110001001000100101000111
0000010010101001000110101111101100110110000111
0000010100110110001111100110100100001010111011
0000000010111001011110010110010101011000111011
0000001000100011000111111100000111001111011011
0000001000100111000011111100000111001111011011
0000001010111011011100001100010101100011011011
0000100011001101101111101001000100100101011011
0000100111001001101111101001000100100101011011
0000001000101110011101101000111101010001011011
0000001001101110011001101000111101010001011011
0000001001101110011101101000101101010001011011
0000001001101110010101111000111001010001011011
0000001001101110011101101000111001010001011011
0000001000100111000111111100000111001110011011
