000000010010111
000000010011101
000000011001011
000000100011011
000000100100111
000000100101011
000000100110101
000000101000111
000000101001011
000000101001101
000001000011011
000001000011101
000001000101011
000001000101101
000001000111001
000001001000111
000001001010011
000001001100011
000001001100101
000001010010011
000001010100011
000010000100111
000010000101011
000010001000111
000010001001011
000010001001101
000010001011001
000010001100011
000010001100101
000010001101001
000010010001011
000010010010101
000010010100011
000010010100101
000010100010011
000010100100011
