000000110111
000001010111
000010011101
000010101011
000010110011
000100010111
000100011011
000100100111
000100101011
000100110011
000100110101
000100111001
000101000111
000101001101
000101010011
000101010101
