00000000000011001010111
00000000010010110001101
00000000011000010101011
00000000100010001001111
00000000100100011101001
00000000101011001000011
00000000101100100100011
00000000110000101000111
00000001000000101100111
00000001000001110101001
00000001000010010110011
00000001001001010000111
00000001010000100011011
00000001010001001001101
00000001010010000110011
00000001010100011000011
00000010000010100111001
00000010000101011000011
00000010000101100001101
00000010001000000101111
00000010001000011101001
00000010001010010010101
00000010010100010001101
00000010010100011000101
00000100000100001001111
00000100001001101100001
00000100001010100010011
00000100001100010011001
00000100010001010100101
00000100010010000010111
00000100010110000101001
00000100100001000100111
00000110010000100010011
