00000001001010111
00000001001101011
00000001100101011
00000010001111001
00000010010110011
00000100010001111
00000100100010111
00000101101000011
00001000010011101
00001000010110011
00001000100010111
00001000110010011
00001001001010101
00001010001000111
00001010001001011
00001010010001011
