0000000000000010111
0000000000000100111
0000000000001010011
0000000000010001011
0000000000010100011
0000000000100010011
0000000000100010101
0000000000100100011
0000000000101000011
0000000001000001011
0000000001000001101
0000000001000010011
0000000001000100101
0000000001001000011
0000000010000000111
0000000010000001101
0000000010000010101
0000000010000011001
0000000010000100011
0000000010000110001
0000000010001001001
0000000010100000011
0000000100000100011
0000000100000100101
0000000100000101001
0000000100001001001
0000000100001010001
0000000100010000101
0000000100010001001
0000001000000100101
0000001000001000011
0000001000001001001
0000001000001100001
0000001000010000101
0000001000100000101
0000001000100001001
