000000000100100111
000000010001010101
000000010001101001
000000010100010101
000000100001011001
000000100001110001
000000100011000011
000001000001000111
000001000001010011
000001000001010101
000001000010000111
000001000011000011
000001000011000101
000001000011010001
000001000100010101
000001000101000011
000001000101000101
000001000101010001
000001001000001011
000001001000011001
000001001000101001
000001001001001001
000001010001000101
