00000000000101000101000100010101
00000000010000010100010001010101
00000000010100000100010001010101
00000000010100010001000101000101
00000001000000110000010100000111
00000001000001010001000100010101
00000001000001110000010100000011
00000001000010010100000101001001
00000001000101010001000100000101
00000001001000010000010100100101
