00111111110110110101111111111101111110111011111111111111111111
00011101111111011011111101111111101111111101111111111111111111
00111111111101111111101101110101111111011110111111111111111111
00101111001111111111011111111101110111111111111011111111111111
00111011111111111111111111011111101101101111101011111111111111
00101111111011111111111111011101111011111101111101111111111111
00111110111111111111111111011101111011011111110101111111111111
00111110111111111101111111111111111011101111011010111111111111
00110111111011111110111110110101111111111111111111011111111111
00110101111111111110011111101011111111111111111111101111111111
00111111011011110111111110111010111111111111111111101111111111
00111111010111011011111111111111011110111111111111101111111111
00111010101111111111111101111111111111011011111111101111111111
00010111110111111111111111111111011111101111110111101111111111
00101011110111111111110111110111111101111111111111110111111111
00110111111011110111110111110101111111111111111111111011111111
00111111110110111101111111111111111111111101111010111011111111
00110111111111111101111111111110101111011111011111111101111111
00011011111111110111011111011111101111111111111111111110111111
00111010111111111101101111111110111111110111111111111110111111
00110111111111111111111111111010111111110111111110011110111111
00111110111011111111111111111111111111101101011011111111011111
00101111111111111111110111111111011110111111101110111111011111
00111011111110111111010111111111101101111111111111111111101111
00101111111111011111111011011101111111111111111011111111101111
00101111110111111111101111111111011111111111011101111111101111
00110111111111111111011111111111110101111111011111101111101111
00110111111111111011110111111111011111111110111111111110101111
00101111111111101111101111111110111111111011111111111101110111
00101111111111011111111011110111111111111111111011111110111011
