000000000000010001010001010001010100010101
000000000000010100000101010001000101010101
000000000001000000010101000101000101010101
000000000001000001010001000100010101010101
000000000001000001010001010101000100010101
000000000001000001010101010000010101010001
000000000001000100010100010100010101000101
000000000001000100010101000101000100010101
000000000001000101000001000101010100010101
000000000001000101000101000101010000010101
000000000001000101010001010100000100010101
000000000001000101010100000100010101000101
000000000001010000000101000100010101010101
000000000001010000010100010001000101010101
000000000001010001000100000101010001010101
000000000001010001010001000001010100010101
000000000100000001010001010100010001010101
000000000100000001010100000100010101010101
000000000100000001010100010000010101010101
000000000100000001010100010100000101010101
000000000100000001010100010100010001010101
000000000100000001010101010000010101000101
000000000100000001010101010100010001000101
000000000100000100010000010101000101010101
000000000100000100010101000101000001010101
000000000100000101000001010100010001010101
000000000100000101000100010101000001010101
000000000100000101010000010001010100010101
000000000100000101010000010101010100010001
000000000100000101010001000001010101010001
000000000100000101010001010100010000010101
000000000100000101010100000101000101010001
000000000100000101010101000001010100010001
000000000100010001000001010101010100000101
000000000100010001010000010001010100010101
000000000100010001010001010001010000010101
000000000100010001010100010000010101000101
000000000100010001010101010000000101000101
000000000100010001010101010000010001000101
000000000100010001010101010000010100000101
000000000100010100000101000101010001000101
000000000100010100000101010001000101000101
000000000100010100010101010000000101010001
000000000100010101000101000001010001000101
000000000100010101010000010001010000010101
000000000100010101010000010001010100000101
000000000100010101010001010001000000010101
000000000101000001000001000100010101010101
000000000101000001000100000101010001010101
000000000101000001000100010000010101010101
000000000101000001000100010100010100010101
000000000101000001010100010100010001000101
000000000101000100000001000101010100010101
000000000101000100010000000101000101010101
000000000101000100010000010101000101000101
000000010000000100000101010100010001010101
000000010000000100000101010101000100010101
000000010000000100010001010001000101010101
000000010000000100010100010001000101010101
000000010000010000010100010001010101000101
000000010000010001000101000001010101010001
000000010000010001000101010100000100010101
000000010000010001010000010001010101000101
000000010000010001010100010001010100000101
000000010000010001010100010001010101000001
000000010000010001010101000001010100010001
000000010000010100000001000101010001010101
000000010000010100000001010001000101010101
000000010000010100010001000101000100010101
000000010000010100010001010000000101010101
000000010000010100010001010001000001010101
000000010000010100010001010001000100010101
000000010000010100010001010100000001010101
000000010000010100010001010100000100010101
000000010000010100010100010001010100000101
000000010000010101000000010101000101000101
000000010000010101000101000101000000010101
000000010000010101000101010001000001000101
000000010000010101010100010001000100000101
000000010001000000010101000101000001010101
000000010001000001000001000100010101010101
000000010001000001010000000100010101010101
000000010001000001010000010100010101010001
000000010001000001010001000100010101010001
000000010001000001010100000100000101010101
000000010001000001010101000000010101000101
000000010001000001010101010000010000010101
000000010001000001010101010000010100010001
000000010001000001010101010100010000000101
000000010001000101000000010101010001010001
000000010001000101000100000101010100000101
000000010001010001000001010100000101010001
000000010001010100010101000001000100000101
000000010001010101000100010000010000010101
000000010001010101010000010001000100000101
000000010100000100010000010001000101010101
000000010100000100010000010101000101000101
000000010100000100010001000001000101010101
000000010100000100010001000100000101010101
000000010100010000010001000100010101000101
000000010100010001000001000001010001010101
000000010100010101000100010000010000010101
