0000010001110110111111
0000011001101010111111
0000011001111011010111
0000011010110101110111
0000011010111001101111
0000011011010011110111
0000011011011010111011
0000101100110101111101
0001000101111011001111
0001001001111010101111
0001001101011110001111
0001001110100110101111
0001001110111101001101
0001001111011010011101
0001010011111100100111
0001010110100011110111
0001010110111001101101
0001011000110111101101
0001011001110110100111
0001011010011001110111
0001100101010011111011
0001101001010101111011
0001101001100101011111
0001101110101001001111
0001110101001001101111
