00000000011000000011110000011001100000111111
00000001001000000110110000010110100000111111
00000011001000000111101000001100010000011111
00000010011000001011110000010001100000011111
00000001101000001110110000010100100000011111
00000000101001010001010000000111100101001111
00000000011010100000110000000111101010001111
00000000111010100000110000000101101010001111
00000001001100000011010100000101111000001111
00000001011110000011010100000100110000001111
00000000011000001111110000011001100000001111
00000010001000001100110000101010100001110111
00000100001000001001111000011000110000110111
00000100001100001001111000011000100000110111
00000010101000011100110000101000100000110111
00000110001100001001111000010000100000110111
00000000110000010101101000000011110001010111
00000000111000010101101000000011010001010111
00000000110100010101101000000011100001010111
00000010100001000101100100001010101100010111
00000010101001000101100100001010001100010111
00000010010100000101100010001001110100010111
00000010100011000101100100001010100100010111
00000001001001100101011010000110000100010111
00000010101011000101100100001010000100010111
00000010011101000101100010001001010000010111
00000001011000001001110000011101100000010111
00000100001000011000110001010010100011100111
00000100110000101000110000110001000011100111
00000100101000111000110001010000100001100111
00000100100000101001100010010010100110100111
00000100101000101001100010010010000110100111
00000000111000101001011000000010110010100111
00000000101100101001011000000011100010100111
00000100100001101001100010010010100010100111
00000100010000111000110000110011000010100111
00000100101001101001100010010010000010100111
00000100001000001101111000011000110000100111
00000110001000001101111000010000110000100111
00000001011000000101110000011101100000100111
00000100001100001101111000011000100000100111
00000010110000010001101000001011110001000111
00000010111000010001101000001011010001000111
00000010110100010001101000001011100001000111
00000010111100010001101000001011000001000111
00000000011010100010110000000111101010000111
00000100101000100001011000010011110010000111
00000100111100100001011000010010100010000111
00000000110110000001110110000011010100000111
00000000110101000001110110000011011000000111
00000001101000000111110000010100100000111011
00000000011000000110110001100001100011011011
00000010001000010110010010001001100101011011
00000010011000010110010010001000100101011011
00000001001010010010010000001101101001011011
00000010001001010110010010001001100001011011
00000010011001010110010010001000100001011011
00000000011001100000110000001101100110011011
00000010001010000100110001001100101010011011
00000011001010000100110001001000101010011011
00000010001010100100110001001100101000011011
00000011001010100100110001001000101000011011
00000000011000110110110001100001100000011011
00000001001000001111110000010110100000011011
00000101001000101000110010010000100110101011
00000100001010001010010001010001101010101011
00000001011000101010100100000101001010101011
00000001010010101010100100000101100010101011
00000100001001101000110010010100100010101011
00000000011000001010111100000001111000101011
00000100011010101010010001010000101000101011
00000000011010001010111100000001110000101011
00000001010100011000010000001101110011001011
00000001011010010110010000001100101001001011
00000001010011000010110010100101001001001011
00000010011000100010110001101001100001001011
00000001010000100010111010000101010110001011
00000001011001100100110000001001100110001011
00000001010100100010111010000101000110001011
00000101010000100010100100010101101010001011
00000001001110000010111001000100101010001011
00000001010001100010111010000101010010001011
00000010011000010010110001101001100010001011
00000101011010100010100100010101000010001011
00000001010101100010111010000101000010001011
00000001010010010010110010100101001100001011
00000001001010100010111001000100111000001011
00000010001100010100010000011001110001110011
00000101001000001100010000110101100001110011
00000101011000001100010000110100100001110011
00000010101000001101110000101000100001110011
00000100011001001100100001010001000110110011
00000000011000001100110110000001101100110011
00000110001001000100110100001000101100110011
00000100010001101100100001010001100100110011
00000010001011000100110100011000100100110011
00000101001000011100010000110101100000110011
00000100101100001000111000011010100000110011
00000010001000011101110000101010100000110011
00000010010000010100111001001001010011010011
00000010010100010100111001001001000011010011
00000011001000010100010010001101100101010011
00000010011100011100010000011000110001010011
00000010010000110100111001001001010001010011
00000011001001010100010010001101100001010011
00000001011000100100110001100101100001010011
00000010010100110100111001001001000001010011
00000001011001100010110000001001100110010011
00000010001010000110110001001100101010010011
00000001011000010100110001100101100010010011
00000010001001001100110100011000101100010011
00000010111100000100100010001011010100010011
00000100011010000100110110010001100100010011
00000110001011001100110100001000100100010011
00000100011001000100110110010001101000010011
00000010001010100110110001001100101000010011
00000010110101000100100010001011110000010011
00000100101000011001110001010000100011100011
00000100010000101001110000110011000011100011
00000100001000111001110001010010100001100011
00000100001000101010110010010100100110100011
00000101011010001000010001010100101010100011
00000101001001101010110010010000100010100011
00000100110000111001110000110001000010100011
00000100011011010000110000100001101100100011
00000100010101100010010000010011110100100011
00000010011010001000110110001001100100100011
00000001011000001000111100000101111000100011
00000101001010101000010001010101101000100011
00000001011100001000111100000101101000100011
00000010011001001000110110001001101000100011
00000001011010001000111100000101110000100011
00000001011110001000111100000101100000100011
00000100011011001000110000100001101101000011
00000001011100010010011000101101010001000011
00000010101000110100100100011011100010000011
00000001001000001011010001001100100010111101
00000000101000100011010000101010100011011101
00000010101000100011010000100010100011011101
00000000101000110011010000101010100010011101
00000010101000110011010000100010100010011101
00000010001100000110010100001010111000011101
00000010101110000110010100001000110000011101
00000001011000001110010000010111100000011101
00000000101000001011010010100010100101101101
00000101100001001001010000110010000101101101
00000000101010100001010000010110101010101101
00000001001101001010011000000110100100101101
00000100100001011001010000110110000100101101
00000000101001011011010010100010100000101101
00000001001000101111010001001100100000101101
00000000101000100111010000101010100011001101
00000010101000100111010000100010100011001101
00000100101001000011010010110010100001001101
00000000101000110111010000101010100010001101
00000010101000110111010000100010100010001101
00000101001001000010011000010110110100001101
00000100101000010011010010110010100100001101
00000001001110000011110100000101110000001101
00000100001000101001010100011000101010110101
00000100101010001100010010010000101100110101
00000100001011001100010010010010101000110101
00000010100010100101010001011010001000110101
00000100011000001001011000011001110000110101
00000010011000011100010000101011100000110101
00000100011100001001011000011001100000110101
00000000101000010101011010000010110101010101
00000000010101000101010001010101010101010101
00000001010001010001010001010101010101010101
00000001010100010001010001010101010101010101
00000001010101000001010001010101010101010101
00000100000101010100010001010101010101010101
00000001010001010100010001010101010101010101
00000101000001010100010001010101010101010101
00000001010100010100010001010101010101010101
00000101000100010100010001010101010101010101
00000101000101000100010001010101010101010101
00000100010001010101000001010101010101010101
00000100010100010101000001010101010101010101
00000001010101000101000001010101010101010101
00000100000101000101010100010101010101010101
00000000010101010001010100010101010101010101
00000100010100010001010100010101010101010101
00000100010101000001010100010101010101010101
00000100010001010100010100010101010101010101
00000001010100010100010100010101010101010101
00000100010101000100010100010101010101010101
00000101000101000100010100010101010101010101
00000101010001000100010100010101010101010101
00000100010101010000010100010101010101010101
00000101000001010101000100010101010101010101
00000101000101000101000100010101010101010101
00000100010001010101010000010101010101010101
00000100010101000101010000010101010101010101
00000001010000010101010101000101010101010101
00000001010001000101010101000101010101010101
00000001000101010001010101000101010101010101
00000001010001010001010101000101010101010101
00000001010100010100010101000101010101010101
00000001010100010101000101000101010101010101
00000101000001010101010001000101010101010101
00000101010001010001010001000101010101010101
00000101010100010100010001000101010101010101
00000101000100010101010100000101010101010101
00000000010101000101010101010001010101010101
00000100000101010001010101010001010101010101
00000100010100010101000101010001010101010101
00000100010101010001000101010001010101010101
00000100010101010100000101010001010101010101
00000101000100010101010001010001010101010101
00000001010101000101010001010001010101010101
00000101010001000101010001010001010101010101
00000101010101000100010001010001010101010101
00000100010101000101010100010001010101010101
00000101000101000101010100010001010101010101
00000100010101010001010100010001010101010101
00000101010001010001010100010001010101010101
00000101010101000101000100010001010101010101
00000100000100010101010101010100010101010101
00000100000101010100010101010100010101010101
00000001000101010101000101010100010101010101
00000100000101010101000101010100010101010101
00000101000100010101000101010100010101010101
00000101000101010001000101010100010101010101
00000001010001010101010001010100010101010101
00000100010100010101010001010100010101010101
00000101000100010101010001010100010101010101
00000101010100010001010001010100010101010101
00000101000101010100010001010100010101010101
00000101010100010100010001010100010101010101
00000001010100010101010100010100010101010101
00000101000100010101010100010100010101010101
00000100010101000101010100010100010101010101
00000101010100010001010100010100010101010101
00000101000101010101000100010100010101010101
00000101010100010101000100010100010101010101
00000101000100010101010101000100010101010101
00000101000101010100010101000100010101010101
00000101000101010101000101000100010101010101
00000101000100010101010101010000010101010101
00000001010001010101000101010101000101010101
00000101010001010001000101010101000101010101
00000001000101010101010001010101000101010101
00000001010001010101010001010101000101010101
00000100010001010101010001010101000101010101
00000100010101000101010001010101000101010101
00000101000101010100010001010101000101010101
00000100010101010001010100010101000101010101
00000101010101000100010100010101000101010101
00000100010101010101010000010101000101010101
00000001010001010101010101000101000101010101
00000100010001010101010101000101000101010101
00000001010100010101010101000101000101010101
00000101010001000101010101000101000101010101
00000101010001010101010001000101000101010101
00000001010001010101010101010001000101010101
00000101000101010101010001010001000101010101
00000101010001010101010001010001000101010101
00000001010001010101010101010100000101010101
00000100010001010101010101010100000101010101
00000101000100010101010101010100000101010101
00000100010101010101010001010100000101010101
00000100010100010101000101010101010001010101
00000101000101010100010001010101010001010101
00000001000101010101010100010101010001010101
00000100010001010101010100010101010001010101
00000100010101000101010100010101010001010101
00000100010101010001010100010101010001010101
00000101000101010101000100010101010001010101
00000001010001010101010101000101010001010101
00000100010100010101010101000101010001010101
00000001010100010101010101010001010001010101
00000100010101000101010101010001010001010101
00000100010101010101000101010001010001010101
00000101010001010101010100010001010001010101
00000101000101000101010101010100010001010101
00000101000101010101000101010100010001010101
00000101000101010101010001010100010001010101
00000101000101010101010100010100010001010101
00000101000101010101010101000100010001010101
00000100010001010101010101010101000001010101
00000100010101010101010100010101000001010101
00000010100010001101010001011010001010010101
00000100010101000101000101010101010100010101
00000101010001000101000101010101010100010101
00000001000101010101010001010101010100010101
00000100010001010101010001010101010100010101
00000100010101010100010001010101010100010101
00000100010101010001010100010101010100010101
00000100010101010100010100010101010100010101
00000100010101010101000100010101010100010101
00000100010101010101010000010101010100010101
00000100010100010101010101010001010100010101
00000100010101010001010101010001010100010101
00000100010101010101010100010001010100010101
00000101000100010101010101010100010100010101
00000101010001000101010101010100010100010101
00000100010101010101010100010100010100010101
00000101000101000101010101010101000100010101
00000100010101010101010001010101000100010101
00000100010101010101010100010101010000010101
00000100111000011000010001010001100011100101
00000100100001001011010000110110000101100101
00000100011000111000010001010011100001100101
00000100110000101001000010010011100110100101
00000100111000101001000010010011000110100101
00000000101000101001111000000011110010100101
00000100110001101001000010010011100010100101
00000100001010101101010100011000100010100101
00000100111001101001000010010011000010100101
00000100101101100001010001000010110100100101
00000100011000001101011000011001110000100101
00000100011100001101011000011001100000100101
00000100010101010000010101010101010101000101
00000100010101010001000101010101010101000101
00000101000100010101010001010101010101000101
00000100010001010101010100010101010101000101
00000101000100010101010100010101010101000101
00000100010101010001010100010101010101000101
00000100010101010001010101000101010101000101
00000100010101000101010101010001010101000101
00000100010101010101000101010001010101000101
00000100010101010101010100010001010101000101
00000100010101010101010101010000010101000101
00000100010101010101010001010101000101000101
00000100010101010101010100010101010001000101
00000100101101001001010001000010110110000101
00000100111000100001111000010010110010000101
00000100101100100001111000010011100010000101
00000100011000001110110000110000100001111001
00000001001010000110010010010100101100111001
00000100001100001100010100010100111000111001
00000010001110001100011000001100101000111001
00000001001011000110010010010100101000111001
00000100001000011110110000110001100000111001
00000010001000100110011000101000110011011001
00000010001000010110110010001001100101011001
00000010011000010110110010001000100101011001
00000010001001010110110010001001100001011001
00000010011001010110110010001000100001011001
00000010001100110110011000101000100010011001
00000001001010001110010010010100101100011001
00000001001011001110010010010100101000011001
00000010001110000111010100001010110000011001
00000100011000101000010010010101100110101001
00000100011010001010110001010000101010101001
00000001001001001011011000000110110100101001
00000100001010101010110001010001101000101001
00000100001010001101010010010010101100110001
00000010001010001110011000001100111000110001
00000100001110001110010100010100110000110001
00000100001001110110010000111000001101010001
00000100010001010101010001010101010101010001
00000100010101000101010001010101010101010001
00000100010101000101010100010101010101010001
00000100010101010100010101000101010101010001
