000001001000001001010011011
000001001000001001100101101
000001001000011001010001011
000001001000011011010001001
000001001000101001100001101
000001001010001001000011011
000001001010001011000011001
000001001010011001000001011
000001001100001001000101101
