000001001001001000001001001001010011011011011
000001001001001010001001001001000011011011011
000001001001001000011001001001010001011011011
000001001001001010011001001001000001011011011
000001001001001000001011001001010011001011011
000001001001001010001011001001000011001011011
000001011001001010001001001001000011001011011
000001001001001000011011001001010001001011011
000001011001001000011001001001010001001011011
000001001001001010011011001001000001001011011
000001001000011001000011001010001011010011011
000001001010001001000011011000001011010011011
000001001010011001000001011000001011010011011
000001011010001001000011001000001011010011011
000001001010001001000011011000011001010011011
000001001000011001010001011010001001010011011
000001001000011001010001001010011011000011011
000001001010001001000011011010001011000011011
000001001000011001010011001010001011000011011
000001001010001001000011011010011001000011011
000001001010001011010001011000011001000011011
000001001010001001010011011010001001000011011
000001011000011001010011001010001001000011011
000001001010011011010001001010001001000011011
000001001001001000001001011001010011011001011
000001001001001010001001011001000011011001011
000001001011001010001001001001000011011001011
000001001001001000011001011001010001011001011
000001001011001000011001001001010001011001011
000001001001001010011001011001000001011001011
000001001011001010011001001001000001011001011
000001001001001000001011011001010011001001011
000001001011001000001011001001010011001001011
000001001001001010001011011001000011001001011
000001001011001010001011001001000011001001011
000001011011001010001001001001000011001001011
000001001001001000011011011001010001001001011
000001011001001000011001011001010001001001011
000001001011001000011011001001010001001001011
000001011011001000011001001001010001001001011
000001001001001010011011011001000001001001011
000001001000011011000011001010001011010001011
000001001010011001000011001010001011010001011
000001011010001001000011001010011001010001011
000001001000011011010001001010011001010001011
000001001000011011000011011010001001010001011
000001001010011001000001011010011011000001011
000001001000011011010011001010001011000001011
000001001010011001000011011010011001000001011
000001001010011001010001011010011001000001011
000001001010011011000011001010011001000001011
000001001010011011010001001010011001000001011
000001001001001000001001001001100101101101101
000001001001001100001001001001000101101101101
000001001001001000101001001001100001101101101
000001001001001100001101001001000101001101101
000001001001001000101101001001100001001101101
000001001001001100101101001001000001001101101
000001001000101001000101001100001101100101101
000001001100001001000101101000101001100101101
000001001000101001100001101100001001100101101
000001001000101001100001001100101101000101101
000001001100001001000101101100001101000101101
000001001000101001100101001100001101000101101
000001001100001001000101101100101001000101101
000001001100001101100001101000101001000101101
000001001100001001100101101100001001000101101
000001001100101101100001001100001001000101101
000001001001001000001001101001100101101001101
000001001001001100001001101001000101101001101
000001001101001100001001001001000101101001101
000001001001001000101001101001100001101001101
000001001101001000101001001001100001101001101
000001001001001100001101101001000101001001101
000001001101001100001101001001000101001001101
000001001001001000101101101001100001001001101
000001001101001000101101001001100001001001101
000001001001001100101101101001000001001001101
000001001000101101000101001100001101100001101
000001001100101001000101001100001101100001101
000001001000101101100001001100101001100001101
000001001000101101000101101100001001100001101
000001001000101101100101001100001101000001101
000001001001001000001001001011010011011011001
000001001001001010001001001011000011011011001
000001001001011010001001001001000011011011001
000001001001001000011001001011010001011011001
000001001001011000011001001001010001011011001
000001001001001010011001001011000001011011001
000001001001011000001011001001010011001011001
000001001001001010001011001011000011001011001
000001001001011010001011001001000011001011001
000001001001001000011011001011010001001011001
000001001001011000011011001001010001001011001
000001001001001010011011001011000001001011001
000001001001011010011011001001000001001011001
000001001010001001010001011000011011010011001
000001001010001011000011011000001011010011001
000001001010001011000001011010011001010011001
000001001010001011010001011000011001010011001
000001001010011001010001011000011011000011001
000001001010011011000001011010001011000011001
000001001010011001010011011000001011000011001
000001001010011011010001011000011001000011001
000001001001001000001001001101100101101101001
000001001001001100001001001101000101101101001
000001001001101100001001001001000101101101001
000001001001001000101001001101100001101101001
000001001001101000101001001001100001101101001
000001001001001100101001001101000001101101001
000001001001101000001101001001100101001101001
000001001001001100001101001101000101001101001
000001001001101100001101001001000101001101001
000001001001001000101101001101100001001101001
000001001001101000101101001001100001001101001
000001001001001100101101001101000001001101001
000001001001011000001001011001010011011001001
000001001001001010001001011011000011011001001
000001001001011010001001011001000011011001001
000001001001001000011001011011010001011001001
000001001001011000011001011001010001011001001
000001001001001010011001011011000001011001001
000001001001011010011001011001000001011001001
000001001001001100001001101101000101101001001
000001001001001000101001101101100001101001001
000001001001001100101001101101000001101001001
000001001001001010001011011011000011001001001
000001001001001000011011011011010001001001001
