00000000000000000000100100111
00000000000001000100001000011
00000000000010000001100000101
00000000000010000010000010101
00000000000010000010100100001
00000000000100000000100110001
00000000000100001010000001001
00000000000101000000000010011
00000000001000000000110010001
00000000001000000001000010101
00000000010000000001000000111
00000000010000001000001000011
00000000100000000100001001001
00000000100010000010000001001
