0000000000000000011
0000000000000000101
0000000000000001001
0000000000000010001
0000000000000100001
0000000000001000001
0000000000010000001
0000000000100000001
0000000001000000001
