000000010010111000001111001010101111011
000000010010111001000111001010101111011
000000010010111001001111001000101111011
000000010010111001001111001010101110011
000000011000000101101010100011111011111
000000011000011011011011011000011011011
000000011011000011000011011011011011011
000000100010111110110011001110000110101
000000100011010111000100101001101111101
000000100011010111000101101000101111101
000000100011010111000101101001100101111
000000100011010111000101101001100111101
000000100011010111000101101001101011101
000000100011110110010111100100011010101
000000100101110010010110010101011100111
000000101000101101101101101000101101101
000000101011101110000011110001100101101
000000101011101110010011100001100101101
000000101101000101000101101101101101101
000000110000101001111001100101010011111
000000110010001100100111110111000101011
000000110010100010000100111111011100111
000000110101010010000010111110101100111
000000110101010010001010111110100100111
000000110101101101010101000011100011011
000001000010011111101110011110000011001
000001000010101100001011100110101111101
000001001010101100001010100110101111101
000001001010101100001011000110101111101
000001010000110101001000101111101100111
000001010001101011000011111100110010011
000001010010011001011010011011011001011
000001010010110001000110001101011111101
000001010011001011001011011010010011011
000001010011011010010011001011001011011
000001010100001011001011111100110010011
000001010100100010011110100110111100011
000001010101001010001011111100110010011
000001010101001011000011111100110010011
000001010101001011001011111100110000011
000001011001010010011010011001011011011
000001011001011011010011011001010010011
000001011010010011011011001011001010011
000001011011001011001010010011011010011
000001011011011001010011010010011001011
000001100010001111110111100001000011011
000001100101000100001001111110011001111
000001100101000100001001111110110001111
000001100101000100001011111100110001111
000001100101100010010100011101001101111
000001110000110001001000101111101100111
000001110000110101001000101110101100111
000001110000110101001000101111101000111
000001110101100010010100001101001101111
000001111010001011000010100100011011111
000001111011000011000010100100011011111
000001111011001001000010100100011011111
000010000101011000111011001100011110011
000010001000100111110111000101010101101
000010001000110110011110001011011100101
000010001001011010011001011011011010011
000010001010011011011011001010011011001
000010001011010010001010111011100100111
000010001011010011010011011001001011011
000010001011011001001011010011010011011
000010001110000101101100100011011101011
000010010010101010001100011011001111101
000010010100001101110101000110010011111
000010010100010010001011111011001100111
000010010100100010111110110011100001101
000010010101011000110100111110001011001
000010010110010110001101110111000100101
000010010110011110001100010111000110101
000010010110011110001100100111000110101
000010010110011110001100110111000100101
000010010110100010011100011011001011101
000010010110101010001100011011001011101
000010010110101010011100001011001011101
000010010110101010011100011011001001101
000010011001001011011011010011010001011
000010011001010001010011011011011011001
000010011010001001011001011010011011011
000010011010011011001011011010001001011
000010011010101111100110001110010000101
000010011011010011010001001011011001011
000010011011011010001011001001011010011
000010100100111011101010001001011010011
000010100110011011111010001001000101011
000011000100010010001011111011001100111
000011000100100010011110100110111100011
000011000110011011111010001000100101011
000011000110101100101111001000100101011
000011000111101100101011001000100101011
000011001001010010001010111011100100111
000011001001011011010001010010011011011
000011001010010001001011011011011010011
000011010001001010010011011011011001011
000011010010011011001010001001011011011
