00000001110110111101011101011011111
00000010011101110101111011011011111
00000010110011111011111100011011111
00000010111001101011101011111101111
00000010111010101101101111011101111
00000011010111001101101111011101111
00000100101101110110011110101111111
00000100101101110111011110101011111
00000100111011110101101101011101111
00000100111101100111110011110111101
00000100111110010110110111101110111
00000100111110111100111011100101111
00000101001011110111010111011111011
00000101011001011110101110011111111
00000101100011110111110100110111111
00000101101001110111010111001111111
00000101101110011101110101111011011
00000101101111101110110110001101111
00000101101111111011110011001011101
00000110001101110101111011011011111
00000110001111011001011110111011111
00000110010101111110111001101011111
00000110011010111011110110101011111
00000110011101110101111011011010111
00000110101101101110010111011101111
00000110101101101111010111001101111
00000110110100111101110010111110111
00000110111001101011101011110101111
00000110111001101011101011111001111
00000110111011110101101101011100111
00000111010010110100110011111111111
00000111101100011001011101111101111
00001000101111011110111110001011111
00001000101111100010111101111011111
00001000110011111101010111111011011
00001000110111111000111111011101011
00001000111110100011111011110111101
00001000111110111101111010001111101
00001001011101100101111111011110011
00001001011101110101001111111001111
00001001110011001011101011111101111
00001001110011111010111010011101111
00001001110110011101011101011011111
00001010010011111000111011111111011
00001010011101011110110111101110011
00001010011101100101111111011010111
00001010011111011010110111101110011
00001010110001111011111010011011111
00001010111001110010111110111011011
00001010111011010011111100111011011
00001010111011011010011111101100111
00001011000110111110111010111011011
00001011001011101011100111011111101
00001011001011111001100111011111101
00001011001011111011100101011111101
00001011001101011001111010111111101
00001011001101100101111111011110011
00001011001110101001111101101111011
00001011001111101111101100011011101
00001011011001010101110011111101111
00001011011001011001110011111101111
00001011011001011100110011111101111
00001011011100111110110010101110111
00001011011101011000110111111001111
00001011011101011001111100111011101
00001011011111110111100110010110011
00001011100100111100011101111111011
00001011110001110101001101111111101
00001011110111001011001010111011111
00001011110111001011101111101001011
00001011110111011011001010111001111
00001011111110101101100101011100111
00001100011011110001011110111110111
00001100011111110010011111110101011
00001100111011001010111101011111011
00001101001110011101101111110101011
00001101010010111100110011111110111
00001101010010111110110011111100111
00001101010011111101100111101100111
00001101010110111111011100010011111
00001101010111111100100111101100111
00001101111000110001011111011101111
00001101111111010110010111001010111
00001110001001110110110101110111111
00001110011001111111101101001010111
00001110011010110110011010101111111
00001110101011011010011001111011111
00001110111111001001101010011101111
00001111001100101100101011110111111
00001111011100101010001101101111111
00010001010100111011011011011111111
00010001011111101110101111000110111
00010001100101011111010011111011111
00010001110100111011011011010111111
00010010010111110001101111110101111
00010010011100101011101011111101111
00010010101011100010111111011110111
00010010101100111111100110111010111
00010010101101111011100110111010111
00010010101110100010111111011110111
00010010101110101100011110110111111
00010010101110110010111110011110111
00010010101111110111001011001011111
00010010101111110111101110001010111
00010010101111110111101110001011101
00010010110011101111011010110011111
00010010110100101011101011111101111
00010010110111100011111100111011101
00010010111001001011110011111110111
00010010111001001101011111110101111
00010010111001011101110111100101111
00010010111010110011100110111011111
00010010111010110011100111111010111
00010010111011101111011010110001111
00010010111100111111100100111010111
00010011001011111100111001101011111
00010011001110001101011111010111111
00010011001111001101001111010111111
00010011001111001101011111010111011
00010011010111011111100100110101111
00010011010111110001101111010101111
00010011010111110001101111110001111
00010011010111110011110010101111011
00010011010111110111100111000101111
00010011010111110111101111000100111
00010011011010001101011111110110111
00010011011011110101011111011000111
00010011011100011101111110110110101
00010011011110001101011111110110101
00010011011110011010101101011011111
00010011011111110100111101110010101
00010011100011111011110110001111101
00010011101001101010110011111110111
00010011101001101010110111101110111
00010011101001101011101011111001111
00010011101010010010111111011011111
00010011101101101011001111111000111
00010011110001111111011010111001101
00010011110110001111001111011110101
00010011111000101011111111011010011
00010011111000110011111111011010011
00010011111010011010101101111010111
00010011111010110111110011011010011
00010011111110101110011001101001111
00010011111111011010110101100011101
00010100010111011011110110011101111
00010100010111110011011110110101111
00010100011011110101101111011001111
00010100011011111101101111011000111
00010100100110111011111110001101111
00010100101101110110010110101111111
00010100110101111011111100011101101
00010100110110100011111011110111101
00010100111101110101101110010011111
00010101001011001111011101001111111
00010101001100111101111011010011111
00010101001110111100100111111011011
00010101010011010011111001111111011
00010101011011010001111001111111011
00010101011011010011111001101111011
00010101100011110111110100110111011
00010101101001011001100111111111101
00010101101111111001110011001011101
00010101110101110011111101101001011
00010101110111010011111001101101011
00010101110111110001111101101001011
00010110001110011011110100111111101
00010110010100111111101011001101111
00010110010100111111101011101100111
00010110011101001011101001111111011
00010110011101010011110010101111111
00010110011101010011110010111111011
00010110011101011011110110001111101
00010110011110110100111111010110011
00010110100110010101010110111111111
00010110100110011101010100111111111
00010110100110011101010110110111111
00010110100111011101011000111111101
00010110100111111100100111011101011
00010110100111111110100111001101011
00010110100111111111100101010101011
00010110111001010010010111111101111
00010110111001010110010111111101101
00010110111100111101011101000111011
00010111000111011110100100110111111
00010111001110010101101101101111101
00010111011001010010111111011100111
00010111011001110001101001011111111
00010111101101011111000110010011111
00010111101101111101010011101010011
00010111101111010100110100110011111
00010111111011111100101001011100011
00011001010100111010110110101111111
00011001110100101011011011010111111
00011001111100111011101010010110111
00011010010011111001010101111111011
00011010011101010010110011101111111
00011010011101010010111011101111011
00011010101010010010111111011011111
00011010101111101110111001001100111
00011010110011111111011001010100111
00011010111011010011111100101011011
00011010111111101010011110010011011
00011011001001001010110111111110111
00011011001001010100110111111110111
00011011001101111111001010101001111
00011011011011111001101001010111011
00011011101010010110011011110011111
00011011101010010110011111010111011
00011011101010100101100111100111111
00011011111001010011101100111010111
00011011111010100101100111100110111
00011100100101101100110101011111111
00011100100101101110110101001111111
00011100100111001101001010111111111
00011100101011001101001011111110111
00011101110010101100100110101111111
00011101110010101100100110111110111
00011101111101011011010101001001111
00011101111111001100101010010011111
00011101111111011001010101001001111
00011110010100111011101011001101111
