0000001011110110111010111
0000001110101101101110111
0000010100111100110111111
0000010100111101010111111
0000010110011101011111101
0000010111011101101101011
0000011000111001101111111
0000011010111001101101111
0000011011010110111010111
0000011011011010110111011
0000100011011011101011111
0000100101101110110011111
0000100110011101011011111
0000100110101011100111111
0000100111010011101011111
0000101011001001111110111
0000101110110111011100011
0000110011000101111101111
0000110100110010101111111
0000110101000110111011111
0000110110010101101110111
0000110110101011100111011
0000110111110110101000111
0000111010010001110111111
0001000101101101111001111
0001000101110010111110111
0001000101111110101110011
0001001010111100101111101
0001001011101001111110011
0001001101001111010111101
0001001101010001111011111
0001001110100111101101101
0001010001011011100111111
0001010010101110110011111
0001010011011011100111101
0001010011101101100111101
0001010011111101010011011
0001010011111101100110101
0001010110100111110011011
0001011001111110100100111
0001011011111001001010111
0001011100100101011101111
0001011100100101111100111
0001011100101111101010011
0001011101110110100100111
0001011110110010101001111
0001101010110010011110111
0001101110101001011001111
0001110100110010100111111
0001110101001001101101111
