00000010000001000011100000110000111
00000010000001001001100100010010011
00000010000001001010100001010010101
00000010000011000000100001110000111
00000010000011000001100001010000111
00000010000011000010100001110000011
00000010000011000011100000110000101
00000010000011000011100001010000011
00000010000011001000100100010010011
00000010000011001000100100110010001
00000010000101000000100101010010101
00000010000101000001100000110000111
00000010000101000001100001110000011
00000010000101000010100100010010101
00000010000101001000100101010000101
00000010000101001010100001010010001
00000010000101001010100100010000101
00000010000111000001100000110000101
00000010000111000010100000110000011
00000010001001000000110010011001001
00000010001001000100110000011001001
00000010001001010000101000010101001
00000010001001100000110010010001001
00000010001001100100110000010001001
00000010010001000010100001010010101
00000010010001000010100101010000101
00000010010001001000100000110010011
00000010010001001001100100010000011
00000010010011001000100100010000011
00000010010101001000100001010000101
