000000000010110011101010011111
000001000101111000101101010011
000001001100111011000011010101
000010001100011001010011100111
000010001100101000110100101111
000010001100101010110100100111
000010001100111001010011100011
000010001101101010110000100111
000010010100101100011010110101
000010010110001001010001110111
000010010110001001110001110101
000010010110011001110000110101
000010010110101000101110010011
000010010110101100011010100101
000010011100001010110110100011
000010011100111001010001100011
000010011101001010110010100011
000010011110011001010000110101
000010100100011010011000111011
000010100100011110011000101011
000010100101001000110101101011
000010111101001000110010100011
