000000000000010100010101
000000000000101000010011
000000000001000100010101
000000000010000100100101
000000000010010000100101
000000000100000101010001
000000000100010001000101
000000000100010100000101
000000001000000010110001
000000001000000111000001
000000001000001100000011
000000010000000100000111
000000010000000100010101
000000010000000100100011
000000010000000100100101
000000010000000101000101
000000010000001000000111
000000010000001100000011
000000010000001100000101
000000010000001100100001
000000010000010000010101
000000010000010001000101
000000010000010100000011
000000010000010100000101
000000010000010100010001
000000010000010100100001
000000010000010101000001
000000010000100001001001
000000010000100100001001
000000010001000000010011
000000010001000000010101
000000010001000000110001
000000010001000001010001
000000010001000010010001
000000010001000100000101
000000010001000100010001
000000010010000100000101
