00000000010000000001000000010001010101
00000000010000000100000001000001010101
00000000000100010000000001000001010101
00000000000001000001000001000100010101
00000000010000010000010000000100010101
00000000000001000000010001010000010101
00000000010000000100010000010000010101
00000000000001000100000001000101000101
00000000000100000001000001010001000101
00000000000000010100000100010001000101
00000000010001000000010000010001000101
00000000000000000100010101000001000101
00000000000100010000010100000001000101
00000000000001000100000100010100000101
00000000000100000100010000010100000101
00000000000100010001010000000100000101
00000000000001000001000101010000000101
00000000000000010001010001010000000101
00000000000001000101000001010000000101
00000000000100000101010001000000000101
00000000000001000000000101000101010001
00000000000100000101010000000001010001
00000000000100000001010100000100010001
00000000010000010001010000000100010001
00000000010000000101010001000000010001
00000000010000010000000100010101000001
00000000010000000101010001000001000001
