001011111111101110111001111101111111111111111111111
001101011111101011111110111111101111111111111111111
001111111011111011101111110101101111111111111111111
001111101101011011111111111101110111111111111111111
001111011101101111111011111111111010111111111111111
001101111101011110111111111111111011101111111111111
001111111111101110110101111101111111110111111111111
000110111110111111011111111111011111110111111111111
001111010101111111111111101111111111011011111111111
001101111111111111111111011111011011110101111111111
001101111011111101111101011111111111111110111111111
001111101110111110111111111111111111110101101111111
001111011111111111111111011101101111111110101111111
001110110111111111010111111110111111111111111011111
001111101011011111111111111111101110111111111011111
001110110111111110101111111111101111111111111101111
