00000000000001100000000110001100011
00000000000001100001000110000100011
00000000000010100000001010010100101
00000000000010100001001010000100101
00000000000100100000010010100101001
00000000000100100001010010000101001
00000000001000100000100011000110001
00000000001000100001100010000110001
00000000010000100000000110001100011
00000000010000100000001010010100101
00000000010000100000010010100101001
00000000010000100000100011000110001
00000000010000100001000100001100011
00000000010000100001001000010100101
00000000010000100001010000100101001
00000000010000100001100001000110001
00000000010000100010000110001100001
00000000010000100011000100001100001
00000000010000100100001010010100001
00000000010000100101001000010100001
00000000010001000001000010001100011
00000000010001000010000110000100011
00000000010001000010000110001000011
00000000010001000011000010000100011
00000000010001000011000100001000011
00000000010001100001000010001000011
00000000010001100001000100001000011
00000000010001100011000010000000011
00000000010010000001000010010100101
00000000010010000100001010000100101
00000000010010000100001010010000101
00000000010010000101000010000100101
00000000010010000101001000010000101
00000000010010100001000010010000101
00000000010010100001001000010000101
00000000010010100101000010000000101
00000000100000100001000110000100011
00000000100000100001000110001000011
00000000100000100010000100001100011
00000000100000100010000110001100001
00000000100000100011000010000100011
00000000100000100011000010001100001
00000000100000100011000100001000011
00000000100001000010000010001100011
00000000100001100010000010000100011
00000000100001100010000100000100011
00000001000000100001001010000100101
00000001000000100001001010010000101
00000001000000100100001000010100101
00000001000000100100001010010100001
00000001000000100101000010000100101
00000001000000100101000010010100001
00000001000000100101001000010000101
00000001000010000100000010010100101
00000001000010100100000010000100101
00000001000010100100001000000100101
