000000010001000000010001001001110011
000000010001000000010001011000110011
000000010001000000010001100011011001
000000010001000000010001110010011001
000000010001000000110001001001010011
000000010001000000110001011000010011
000000010001000000110011001001010001
000000010001000000110011011000010001
000000010001000001010001001000110011
000000010001000001010001100010011001
000000010001000001010011001000110001
000000010001000001011001100010010001
000000010001000001110001001000010011
000000010001000001110011001000010001
000000010001000010010001100001011001
000000010001000010010001110000011001
000000010001000010011001100001010001
000000010001000011010001100000011001
000000010001001000010001000001110011
000000010001001000010001010000110011
000000010001001000010011000001110001
000000010001001000010011010000110001
000000010001001000110001000001010011
000000010001001000110001010000010011
000000010001001000110011000001010001
000000010001001001010001000000110011
000000010001001001010011000000110001
000000010001001001110001000000010011
000000010001010000010001001000110011
000000010001010000010001100010011001
000000010001010000010011001000110001
000000010001010000110001001000010011
000000010001010010010001100000011001
000000010001011000010001000000110011
000000010001011000010011000000110001
000000010001011000110001000000010011
000000010001100000010001000011011001
000000010001100000010001010010011001
000000010001100001010001000010011001
000000010001100010010001000001011001
000000010001100010010001010000011001
000000010001110000010001000010011001
000000100010000010100010000100110011
000000100010000010110010000100100011
000000100010000100100010000010110011
000000100010000100100010100000110011
000000100010000100110010000010100011
000000100010000100110010100000100011
000000100010100000100010000100110011
000000100010100000110010000100100011
000000110001000001010001001000010011
000000110001001000010001000001010011
000000110001001000010001010000010011
000000110001010000010001001000010011
