00000000000000000001011
00000000000000000010011
00000000000000000100011
00000000000000000100101
00000000000000001000011
00000000000000001000101
00000000000000010000011
00000000000000010000101
00000000000000010001001
00000000000000100000011
00000000000000100000101
00000000000000100001001
00000000000001000000011
00000000000001000000101
00000000000001000001001
00000000000001000010001
00000000000010000000011
00000000000010000000101
00000000000010000001001
00000000000010000010001
00000000000100000000011
00000000000100000000101
00000000000100000001001
00000000000100000010001
00000000000100000100001
00000000001000000000101
00000000001000000001001
00000000001000000010001
00000000001000000100001
00000000010000000010001
00000000010000000100001
00000000010000001000001
00000000100000001000001
