000000100000110000011000010100001110000111
000000100000110000101000001100010010001111
000000100000110000101000101100010010000111
000000100000110000111000010100001110000011
000000100000110001101000101100000010000111
000000100001010000101001000100101010010101
000000100001010010001000010110000011010101
000000100001010010001100010110000010010101
000000100001010010101001000100101010000101
000000100001011010001100010100000010010101
000000100001110000001000101100011010000011
000000100001110000111000010100000110000011
000000100001110001001000101100001010000011
000000100010010001001100000110010011001001
000000100010011000001000100100001011001101
000000100010011000001000110100001011001001
000000100010011000101000110100000011001001
000000100010011001001100000110010010001001
000000100011011000101000100100000011001001
000000100011110001001000001100001010000011
000000100100010000011001000101000010110011
000000100100010000011011000101000010010011
000000100100010010001000001100100110010011
000000100101010000001100010110100010000101
000000100101010010101001000100001010000101
000000100101011000001100010100100010000101
000000101000010001001010000100000110101011
