00000001011
00000010011
00000100011
00000100101
00001000101
