0000000001011
0000000010011
0000000100011
0000000100101
0000001000011
0000001000101
0000010000101
0000010001001
