000110111111010111110111111111111111
000110111111101111111101111111101111
000110111111110111110111111111011111
000111010111111111111111011011111111
000111011011111111111111010111111111
000111101101111111111011101111111111
000111101111111111111011101101111111
000111110110111011110111111111111111
001001111011110111111011111111111111
001010111110111111011111111011111111
001011101011111111111011110111111111
001011110111011111011110111111111111
001011110111110111011111111111011111
001011110111111110111111110111110111
001011110111111111111011101011111111
001011111011101111011111101111111111
001011111011111111111001111111110111
001011111101110111101111111111101111
001011111110011101111111111111011111
001011111110110111110111111111110111
001011111111011111011111110111110111
001011111111101111111011101111011111
001011111111101111111011111011110111
001011111111110111110111111110110111
001011111111110111111011111011101111
001011111111111111011110110111011111
001011111111111111011110111010111111
001011111111111111101101110111101111
001101011101111111111101111110111111
001101011111111111101111110101111111
001101110101111111101111011111111111
001101111010111111011111011111111111
001101111101011110111101111111111111
001101111101011111101111011111111111
001101111101011111101111111111110111
001101111101111010111111111101111111
001101111101111111111010111101111111
001101111101111111111101011110111111
001101111110111110101111111111101111
001101111111011111111101011111101111
001101111111100111111111111110101111
001101111111101111101011110111111111
001101111111110111101111111101011111
001101111111111110101111111110101111
001101111111111110111101111101011111
001110101110111111111111101101111111
001110101111111011011111111011111111
001110101111111101101111111110111111
001110110111110111111111010111111111
001110111110101111110110111111111111
001110111110110111111111111110101111
001110111111111111011011111010111111
001110111111111111110110111110101111
001111010101111111101101111111111111
001111011010111111011101111111111111
001111011011101111111111101011111111
001111101101011111111111011101111111
001111101110110101101111111111111111
001111101110111111111110101101111111
001111101111111111101110110101111111
001111110111011111011010111111111111
001111111011101011011111101111111111
001111111101011101101111011111111111
001111111101110110101111101111111111
001111111110111101101110101111111111
