00000000010001101011111
00000000100100110101111
00000000101100011011101
00000000101100111001011
00000000110010010101111
00000001001100011010111
00000001001100101001111
00000001001101110001101
00000001001111000110101
00000001010001011100111
00000001010001100101111
00000001010111001001101
00000001011010001110011
00000001011011001000111
00000001011100110001011
00000001100001010011111
00000001100101000011111
00000010000110010101111
00000010001100100111101
00000010001100101011101
00000010010010110011101
00000010010111001000111
00000010011001101001101
00000010011001101010011
00000010011010011100101
00000010100000111110011
00000010100001100101111
00000010100100101100111
00000010100100111010101
00000010100110001011101
00000010100111010010011
00000010101000111001011
00000010101001001100111
00000010110100110100011
00000010111000110010011
00000100000111001010111
00000100001001111100101
00000100001101100110101
00000100001110110001101
00000100010000101011111
00000100010000110101111
00000100010001111101001
00000100010011010100111
00000100010110001101011
00000100011001010101101
00000100011001101001011
00000100100001110110101
00000100100010101100111
00000100101000110011011
00000100101010001111001
00000100101101110000011
00000100110000101010111
00000100110011101000011
00000100110101101000011
00000100110110000110101
00000100110111010000101
00000101000010101110011
00000101000100011101011
00000101000110001011011
00000101001011000100111
00000101010000011001111
00000101010011001100011
00000101011010100010011
00000101100100101010011
00000101101001010100011
00000101101011000010011
00000101101100010100011
00000101111000010010011
00000101111000100100011
00000110010001010010111
00001000010011101001101
00001000010111000110011
00001000011001101000111
00001000011011001000111
00001000100101100011101
00001000100110001011011
00001000100110010100111
00001000100111100011001
00001000101010010011101
00001000101011010010011
00001000110010110010101
00001000111010010011001
00001001001000111010101
00001001001110010100011
00001001010000100110111
00001001010000110110101
00001001010001011100101
00001001010001100011101
00001001010101100001101
00001001110010010001011
00001001111000010100011
00001010001000101011101
00001010001001001011011
00001010001001001101011
00001010001001100001111
00001010001110010001011
00001010010001000111011
00001010010001001010111
00001101010010001000111
