000101111
000110111
001001111
001010111
001011011
001011101
001101011
