00000001010100010100010101010101010101
00000100010001010101010101000101010101
00000100010101000101010100010101010101
00000100010101010100010101010100010101
00000100010101010101000101010001010101
00000101000100010101010001010101010101
00000101000101000100010101010101010101
00000101000101010101010100010001010101
00000101000101010101010101000100010101
