000000000001001000001001001001001
000000001000001000001001001001001
000000001000001001001000001001001
000000001000001001001001000001001
000000001001000001000001001001001
