00011111010011101111110101001001011011101011111
00011110101100101001111011101011110110011011111
00011110101100101001011111101011110110011011111
00011101101111111010110110101011100100101110111
00011101011111011001011111111011010101001001111
00011101011011011001011111111011110101001001111
00011100100101101101110110111011010101111110111
00011100100101101101110110111011010100111111111
00011100100101101101110110011011010101111111111
00011010111010100101100111110101111101100111111
00011010101101111110111010111010100101100111111
00011010101100101001111111101011110110011011111
00011010011010100101011101100101111111111101111
00011010011001110111111101011011011111001010111
00011001111100100111010101101101011111110110111
00011001010111101110111100100111110100111011111
00011001010111101110011110100111110100111011111
00011000111110011101010010110011111011101111111
00010111111110110111100101011100111011101001011
00010111111010110111101101011100111011101001011
00010111110010111110111011110101001100011111011
00010111010011101011010011110110010111111111011
00010110111111101111101101001100100110100111111
00010110111101101111101111001100100110100111111
00010110111100111011111101011101000111100111011
00010110111100111011011101011101001111100111011
00010110110100111011111101011101001111100111011
00010110100110010111110111011101011100110111111
00010101111011111111110100011111011101010010011
00010101110111110001011111111110111101010001101
00010101101001011111110111110011101011101110011
00010101101001011111110111100011111011101110011
00010101001111011011100111111011001111101101101
00010101001111011011100110111111001111101101101
00010101000101101101111100111111111001110110111
00010100101001011111110111110011111011101110011
00010011111110111101011111001101001100110011111
00010011111011100011101101111111010110110101011
00010011111011010101001101111011111110111000111
00010011110011010011110101111010011011101111111
00010011011110101111111011011110011010111001011
00010011011110101111110011011110011010111001111
00010011011110011010111101011110100111110011111
00010011011110011010101101011110100111111011111
00010011011110011010011101011110100111111011111
00010011010111100110101111010111110011011101111
00010011010111100110101111010111110011010111111
00010011010111100110101111010111100011011111111
00010011010101110011011011110100101111111101111
00010010111100010111010011111111110111100111011
00010010111010110011010011111100111011111111011
00010010110111110010100011101100111111111011111
00010010011110001110101111101100101111111101111
00010001011110101111111011011110011010111001111
00010001010111001111101101011111011011100111111
00001110111011100010110001111011011011011111111
00001110011111111110110101001101111001100101111
00001110011011101010110001111011011011011111111
00001101111111101111001000111010101001110111111
00001101111111011111101110010100010110001111111
00001101111101011010101111001100111111101100111
00001101001101110111001110011111101010111111011
00001101001101100111101110011111101010111111011
00001101001101010111101110011111101010111111011
00001011111111011010110111101110111010010001111
00001011011111110111110111100110010011010011111
00001010111101101101111001111100101011101111101
00001010111101101001111001111100111011101111101
00001010111101100011011011011101111111101001111
00001010111011000111111100111110011010111111011
00001010111011000111011100111110011110111111011
00001010101101111111100011010111111101101110011
00001010101100111111100111010111111101101110011
00001010100101111111100111010111111101101110011
00001001111111011111101111010100010110001111111
00001000110111110011101011111010111111010011111
00000111011101110101011000111101101101101111111
00000110100101110111001110101101111011011111111
00000101111011111111110100011111011101010011011
00000101111001111111101110011001110010111011111
00000101111001111111101011011001110010111011111
00000101111000111111101111011001110010111011111
00000101110111001011110111100101011111111011101
00000101110111001011110111100101011111110011111
00000101110111001011110011100101011111111011111
00000101100011111110000110111111101111110111101
00000101011101100011111110011111001111011111101
00000011011011101010111011101101111011110111011
00000011011010111010111011101101111011110111011
00000010111100110111011101011110110111111010111
00000010101111011011011110011111001110111011111
00000001011101111011110110111011101011111011011
