00000000010000000011000000000100000001110000000111
00000000010000000001000000011100000000110000000111
00000000010000000101000000001100000000110000000111
00000000010000000011000000001100000001010000000111
00000000010000100000000010000100000000110001100011
00000000010000100000000010000100001000100001100011
00000000010000100001000000000100001000100001100011
00000000000000000011000010000100011000010000100011
00000000000001000001000010000100011000010000100011
00000000000001000001000010001100001000010000100011
00000000000000100010000100001000011000100001000011
00000000000000100010000100001100010000100001000011
00000000010000000101000000001100000001110000000011
00000000010000000011000000010100000001110000000011
00000000010000000111000000010100000000110000000011
00000000010000000011000000011100000001010000000011
00000000000100000000010000000100010000010101010101
00000000000100010000000001000000010100000101010101
00000000010001000000010000010000000001010001010101
00000000010000000100000000010000010100010001010101
00000000000001010000010000000000010100010001010101
00000000000001000000010001000001010000010001010101
00000000010000000100010000000001010000010001010101
00000000000100010001000000000001010000010001010101
00000000000000000100000101000100010001000001010101
00000000000000010100000100000100010001000001010101
00000000000100000101000000000100010001000001010101
00000000000000000001000100010101000001000001010101
00000000010000000001000100000101000001000001010101
00000000000000000100010000010100010100000001010101
00000000000000000100000101000100010100000001010101
00000000010000000101000001000001000100000001010101
00000000000100000000000100010001000001010100010101
00000000000100000100000100010000000001010100010101
00000000000100010000000100000000010100010100010101
00000000000100000100010000000000010100010100010101
00000000000100010100000000010000000100010100010101
00000000000100010001000000000001010000010100010101
00000000000100010000000001010000010000010100010101
00000000000000010100010000000000010101000100010101
00000000010000000100000001000001000101000100010101
00000000000100010100000100000000010001000100010101
00000000000000010001000001000101000001000100010101
00000000000000010100010000000101000001000100010101
00000000000001000001000100010100000001000100010101
00000000010000010000000101000100000001000100010101
00000000000000000100000101000001010100000100010101
00000000000000010000000101010000010100000100010101
00000000000000000100010100000101010000000100010101
00000000000000010100010000010001010000000100010101
00000000010100000100000100010000010000000100010101
00000000000001000100000001000001000101010000010101
00000000000001000100000100000100000101010000010101
00000000010000000101000000000100000101010000010101
00000000010000000001000000010001010001010000010101
00000000000100000000010001010001000001010000010101
00000000010000000001000001010100000001010000010101
00000000010000010001000000010100000001010000010101
00000000010000000100000100010000010100010000010101
00000000010000000101000000010100000100010000010101
00000000000000000100010001000101010000010000010101
00000000000000000101000100010001010000010000010101
00000000000001000101010000010000010000010000010101
00000000000001000101010000010000010001000000010101
00000000010100000101000000010000010001000000010101
00000000000000010001000101000101000001000000010101
00000000000100000100010001000101000001000000010101
00000000000100000101010001000001000001000000010101
00000000010001010000000101000100000001000000010101
00000000010000000100000001000101010100000000010101
00000000010000000100010001010000010100000000010101
00000000000001000001010100010100010000000000010101
00000000010000100000000010000100000001010010100101
00000000010000100000000010000100001001000010100101
00000000010000100001000000000100001001000010100101
00000000000000000101000010000100101000010000100101
00000000000010000001000010000100101000010000100101
00000000000010000001000010010100001000010000100101
00000000000100000000010100000000010001010101000101
00000000000001000000010000010100000001010101000101
00000000000001000100000001000100000100010101000101
00000000000100010000000001010000000100010101000101
00000000000101000000000100010001000000010101000101
00000000010000000100010000000001000101000101000101
00000000000000010100000001010000000101000101000101
00000000010000000001000100010000000101000101000101
00000000000000010100000001010000010001000101000101
00000000000000010000000100010101000001000101000101
00000000000101000001000000010001000001000101000101
00000000010000010001000000000100010100000101000101
00000000000100010000010001000000010100000101000101
00000000000000010001010000000101000100000101000101
00000000010001000100000000010100000100000101000101
00000000010000000001000100010001010000000101000101
00000000010000010000010100000100010000000101000101
00000000000100000000010101010001000000000101000101
00000000000100000100010001010001000000000101000101
00000000000001000100000001000000010101010001000101
00000000010000000100000001000000010101010001000101
00000000000001000101000001000000000101010001000101
00000000010001000001000000000100010001010001000101
00000000000000000100000101010001000001010001000101
00000000000001000000010001010100000001010001000101
00000000010001000001000100000100000001010001000101
00000000000000010001010000000101000100010001000101
00000000000101000100000000010100000100010001000101
00000000000000000100010100000101010000010001000101
00000000000100000101000100000001010000010001000101
00000000010000000001000100010100010000010001000101
00000000010000000101000100000100010000010001000101
00000000000100000001000101010000010000010001000101
00000000010001000001010001000000010000010001000101
00000000010000010100010000000101000000010001000101
00000000010000000100000101010001000000010001000101
00000000000101000000010000000001010101000001000101
00000000000000000001000101010000010101000001000101
00000000000000000100010001010000010101000001000101
00000000000001000100010001010000000101000001000101
00000000010000010001000100010000000101000001000101
00000000000001000101010000010000000101000001000101
00000000000100000001010000010100010001000001000101
00000000000101000001010000000100010001000001000101
00000000000001000001010100000101000001000001000101
00000000010000000100010101000100000001000001000101
00000000010000010100000101000100000001000001000101
00000000000000010001000101010000010100000001000101
00000000000001000001010100000101000100000001000101
00000000000001000101000001010100000100000001000101
00000000000001000001010001000101010000000001000101
00000000000001000100010101000001010000000001000101
00000000000100000101010001000001010000000001000101
00000000000000100100001000010000101001000010000101
00000000000000100100001000010100100001000010000101
00000000000000010001000100000000010101010100000101
00000000000100010001000000000001000101010100000101
00000000000000010000010001000100000101010100000101
00000000000000010001000101000000000101010100000101
00000000000000010100000100000100010001010100000101
00000000000000010001010000000100010001010100000101
00000000010001000000010000010000010001010100000101
00000000000000010001010001000000010001010100000101
00000000000100000100010100000000010001010100000101
00000000000101000000010001000001000001010100000101
00000000000000010001000100010100000001010100000101
00000000000001000100010100000000010100010100000101
00000000000100000000010101010001000000010100000101
00000000000001000100000100000100010101000100000101
00000000000100010100000000010000010101000100000101
00000000010000000101000001000000010101000100000101
00000000000000010001010100000001000101000100000101
00000000000100010001010000000100000101000100000101
00000000010001000000010000010001010001000100000101
00000000000100010100000001010000010001000100000101
00000000010000010001000000010001010100000100000101
00000000010001000001000100000001010100000100000101
00000000000000010001000001010100010100000100000101
00000000000000010001010100000100010100000100000101
00000000010001000000010001000101000100000100000101
00000000000001000101010100000100010000000100000101
00000000010000000011000000011100000000110000000101
00000000010000000111000000001100000000110000000101
00000000010000010001000000010100000101010000000101
00000000010000000101000001000100000101010000000101
00000000000000000001000101010001010001010000000101
00000000010000010101000001000100000001010000000101
00000000000100010000010000010101000100010000000101
00000000000100010101000001000001000100010000000101
00000000010000000101000001010100000100010000000101
00000000000100010001010100000100000100010000000101
00000000000001000101010000010001010000010000000101
00000000010001000001000100010100010000010000000101
00000000010001000101000100000100010000010000000101
00000000010001000101010001000000010000010000000101
00000000000100010000000001010101000101000000000101
00000000000100000001010100010100010001000000000101
00000000010000010100010100000100010001000000000101
00000000010000010101000101000000010001000000000101
00000000000100010000010100010101000001000000000101
00000000010000100000000010000100000010010100101001
00000000010000100000000010000100001010000100101001
00000000010000100001000000000100001010000100101001
00000000000000001001000010000101001000010000101001
00000000000100000001000010000101001000010000101001
00000000000100000001000010100100001000010000101001
00000000010000001001000000000100010010010001001001
00000000010000000001000100100100000010010001001001
00000000010001000001000000100100000010010001001001
00000000010000001001000000100100010000010001001001
00000000010001000001000000100100010010010000001001
00000000010000001001000100000100010010010000001001
00000000010001001001000100000100000010010000001001
00000000010000001001000100100100010000010000001001
00000000010000100000000010000100000100011000110001
00000000010000100000000010000100001100001000110001
00000000010000100001000000000100001100001000110001
00000000000000010001000010000110001000010000110001
00000000001000000001000010000110001000010000110001
00000000001000000001000011000100001000010000110001
00000000000100010000000001010000000100010101010001
00000000000100010000000001000001010000010101010001
00000000000100000100000100000001010000010101010001
00000000000001000101000000000100000101000101010001
00000000010000000100000100000100010001000101010001
00000000000000000100010000010101000001000101010001
00000000000000000100010001000001010100000101010001
00000000000100000100010000000001010100000101010001
00000000000000000100010100000100010100000101010001
00000000000001000001000100000101000100000101010001
00000000000000010001000001010100000100000101010001
00000000000100000000010101000100000100000101010001
00000000000000010001010000000101000001010001010001
00000000010001000000010000000101000001010001010001
00000000000100010001000000000101000001010001010001
00000000010000000100000101010000000001010001010001
00000000000001000001010100000001000100010001010001
00000000000100000100000101010000000100010001010001
00000000010000000100000101010000000100010001010001
00000000010000000100000001000101010000010001010001
00000000000000010001000001010101000000010001010001
00000000000100000001000001010101000000010001010001
00000000000100000101000001010100000000010001010001
00000000000100000000010000000101010101000001010001
00000000000100010000000001000001010101000001010001
00000000000001000001010001000000010101000001010001
00000000000001000001010100010000010001000001010001
00000000000001000100010101010000000001000001010001
00000000000000010000010001010001010100000001010001
00000000010000010001001000000100100000010010010001
00000000010000000100000101000000000101010100010001
00000000010000000001000001010000010001010100010001
00000000000001000100000100000101000001010100010001
00000000000001000001000101000100000001010100010001
00000000000100000001010001010000000001010100010001
00000000000100000100000001010100000100010100010001
00000000000001000100000100000101010000010100010001
00000000000001000001000001010101000000010100010001
00000000000100000000010100010101000000010100010001
00000000010000010001000001000101000000010100010001
00000000000001000001010001010100000000010100010001
00000000010000010100000100010100000000010100010001
00000000010000010000000101010000000101000100010001
00000000000100000101000100000001010100000100010001
00000000010000010001000000010100010100000100010001
00000000000100000001010100010100000100000100010001
00000000000100000100000101010001010000000100010001
00000000010000010001010000010100010000000100010001
00000000000100000101000001010101000000000100010001
00000000010000000001000000010001010101010000010001
00000000010000000101010000000001010001010000010001
00000000000100000001000101010100000001010000010001
00000000010000000101000001010100000001010000010001
00000000010000010101000000010100000001010000010001
00000000010000010001010000000101000100010000010001
00000000000001000000010101000101010000010000010001
00000000010000010100010000000101010000010000010001
00000000010000010001010001000101000000010000010001
00000000000100000100000001010001010101000000010001
00000000000100000101000001010001000101000000010001
00000000010000010101010001000000010001000000010001
00000000000100000100010100010101000001000000010001
00000000010000000101010000010100010100000000010001
00000000000100000101010000010101000100000000010001
00000000010000100000000010000100010000110001100001
00000000000001000001000010001100001000010001100001
00000000010000100000000010000100011000100001100001
00000000010000100000000010000100100001010010100001
00000000000010000001000010010100001000010010100001
00000000010000100000000010000100101001000010100001
00000000000100000001000010100100001000010100100001
00000000001000000001000011000100001000011000100001
00000000010000100000000110001100010000010000100001
00000000010000100000001010010100100000010000100001
00000000010000100000010010100101000000010000100001
00000000010000100000100011000110000000010000100001
00000000000001000001000101010001000000010101000001
00000000000100000001010000000001010101000101000001
00000000000100000001010001000000010101000101000001
00000000000001000001000000010101010001000101000001
00000000010000000101010100010000000001000101000001
00000000010000010000000100010101010000000101000001
00000000000100000000010100000100010101010001000001
00000000000100000001010000000100010101010001000001
00000000010000000101000100000100010001010001000001
00000000010000000100010101000100000001010001000001
00000000010000001001000100100100000010010001000001
00000000010000000101010001000001010000010001000001
00000000010000000100010101010100000000010001000001
00000000010000000101010100010000000101000001000001
00000000010000000101010100000001010001000001000001
00000000010000000101010101000001010000000001000001
