0000000000000000000000010111
0000000000000000000000100111
0000000000000000000001010011
0000000000000000000010001011
0000000000000000000010001101
0000000000000000000010010011
0000000000000000000010010101
0000000000000000000010100011
0000000000000000000100001011
0000000000000000000100010101
0000000000000000000100100011
0000000000000000000100100101
0000000000000000000101000011
0000000000000000001000000111
0000000000000000001000010011
0000000000000000001000011001
0000000000000000001000100011
0000000000000000001000100101
0000000000000000001001000101
0000000000000000001010000011
0000000000000000010000001101
0000000000000000010000010101
0000000000000000010000011001
0000000000000000010000110001
0000000000000000010001000011
0000000000000000010010000101
0000000000000000010100000011
0000000000000000100000001101
0000000000000000100000010101
0000000000000000100000011001
0000000000000000100000101001
0000000000000000100000110001
0000000000000000100001010001
0000000000000000100010000011
0000000000000000100010000101
0000000000000000100100000011
0000000000000000100100000101
0000000000000000101000000011
0000000000000001000000000111
0000000000000001000000011001
0000000000000001000000100011
0000000000000001000000100101
0000000000000001000000110001
0000000000000001000001000101
0000000000000001000001001001
0000000000000001000001100001
0000000000000001000010000011
0000000000000001000010001001
0000000000000001000010010001
0000000000000001000100000011
0000000000000001000100000101
0000000000000001001000000011
0000000000000001001000000101
0000000000000010000000001011
0000000000000010000000010011
0000000000000010000000100101
0000000000000010000000101001
0000000000000010000001000011
0000000000000010000001000101
0000000000000010000001010001
0000000000000010000010001001
0000000000000010000010010001
0000000000000010000010100001
0000000000000010000100000011
0000000000000010000100001001
0000000000000010000100010001
0000000000000010001000000101
0000000000000010010000000011
0000000000000010100000000011
0000000000000100000000000111
0000000000000100000000001101
0000000000000100000000010011
0000000000000100000000010101
0000000000000100000000110001
0000000000000100000001000101
0000000000000100000001001001
0000000000000100000001010001
0000000000000100000001100001
0000000000000100000100000011
0000000000000100000100000101
0000000000000100000100001001
0000000000000100000100010001
0000000000000100000100100001
0000000000000100001000000101
0000000000000100001000010001
0000000000000100010000000011
0000000000000100010000000101
0000000000000100010000001001
0000000000000100100000000101
0000000000000101000000000011
0000000000001000000000001011
0000000000001000000000010101
0000000000001000000000100011
0000000000001000000001001001
0000000000001000000001010001
0000000000001000000010000011
0000000000001000000010000101
0000000000001000000010001001
0000000000001000000010010001
0000000000001000000010100001
0000000000001000000100001001
0000000000001000000100100001
0000000000001000000101000001
0000000000001000001000010001
0000000000001000001000100001
0000000000001000010000001001
0000000000001000100000000011
0000000000001000100000000101
0000000000001001000000000101
0000000000001010000000000011
0000000000010000000000010011
0000000000010000000000100011
0000000000010000000000100101
0000000000010000000001000101
0000000000010000000001100001
0000000000010000000010000011
0000000000010000000010000101
0000000000010000000010001001
0000000000010000000011000001
0000000000010000000100000101
0000000000010000000100010001
0000000000010000000100100001
0000000000010000001000000011
0000000000010000001000001001
0000000000010000001000100001
0000000000010000001001000001
0000000000010000010000000101
0000000000010000010000001001
0000000000010000010000010001
0000000000010000100000000011
0000000000010000100000001001
0000000000010001000000000011
0000000000010001000000000101
0000000000010010000000000101
0000000000100000000001000011
0000000000100000000010000011
0000000000100000000010001001
0000000000100000000010100001
0000000000100000000100000011
0000000000100000000101000001
0000000000100000000110000001
0000000000100000001000000101
0000000000100000001000001001
0000000000100000001000010001
0000000000100000001010000001
0000000000100000010000000011
0000000000100000010000000101
0000000000100000010000010001
0000000000100000010000100001
0000000000100000100000001001
0000000000100000100000010001
0000000000100000100000100001
0000000000100001000000010001
0000000001000000000100000011
0000000001000000000100000101
0000000001000000001000000011
0000000001000000001000010001
0000000001000000001100000001
0000000001000000010000000101
0000000001000000010000001001
0000000001000000010000010001
0000000001000000010000100001
0000000001000000100000000101
0000000001000000100000001001
0000000001000000100001000001
0000000001000001000000001001
0000000001000001000000010001
0000000001000001000000100001
0000000001000010000000010001
0000000010000000010000001001
0000000010000000010000010001
0000000010000000100000001001
0000000010000000100000010001
0000000010000000100000100001
0000000010000000100010000001
0000000010000001000000010001
0000000010000001000001000001
0000000010000010000000100001
