000000000000000100011011
000000000000000100011101
000000000000000100100111
000000000000000100101011
000000000000000100110101
000000000000000101000111
000000000000000101001101
000000000000000101010011
000000000000001000010111
000000000000001000100111
000000000000001000101011
000000000000001001000111
000000000000001100001011
000000000000001100010011
000000000000010000100111
000000000000010000110101
000000000000010001000111
000000000000010001001101
000000000000010001100101
000000000000010010001101
000000000000010011000101
000000000000010100000111
000000000000010100001101
000000000000010100010101
000000000000010100100011
000000000000010101000011
000000000000100000011011
000000000000100000011101
000000000000100000101011
000000000000100001011001
000000000000100010001011
000000000000100010001101
000000000000100100010011
000000000000100100010101
000000000000100100011001
000000000000100100100011
000000000000100110000101
000000000000101000010011
000000000000101000100011
000000000000101010000011
000000000000101100000011
000000000001000000010111
000000000001000000011011
000000000001000000110101
000000000001000000111001
000000000001000001110001
000000000001000010010011
000000000001000010010101
000000000001000011010001
000000000001000100000111
000000000001000100001011
000000000001000100001101
000000000001000100010011
000000000001000100010101
000000000001000100011001
000000000001000100100101
000000000001000100110001
000000000001000101000011
000000000001000101001001
000000000001000110000101
000000000001001000000111
000000000001001000010011
000000000001001000010101
000000000001001000011001
000000000001001001000011
000000000001001100000011
000000000001001100000101
000000000001010000000111
000000000001010000010011
000000000001010000100101
000000000001010100000011
000000000001011000000011
000000000001100000001011
000000000010000000100111
000000000010000000101011
000000000010000000110101
000000000010000000111001
000000000010000010100011
000000000010000010101001
000000000010000010110001
000000000010000100001011
000000000010000100011001
000000000010000100100011
000000000010000100100101
000000000010000100110001
000000000010000101000101
000000000010000101010001
000000000010000110000011
000000000010001000000111
000000000010001000001011
000000000010001000100011
000000000010001000100101
000000000010001001000011
000000000010001100000011
000000000010001100001001
000000000010010000000111
000000000010010000100011
000000000010010000100101
000000000010010001000101
000000000010010100000011
000000000010010100000101
000000000010011000000101
000000000010100000001011
000000000010100000100011
000000000010100100000011
000000000010101000000011
000000000100000001000111
000000000100000001001101
000000000100000001010011
000000000100000001100101
000000000100000001110001
000000000100000011000101
000000000100000011001001
000000000100000100001101
000000000100000100010011
000000000100000100100011
000000000100000100100101
000000000100000100110001
000000000100000101000011
000000000100000101001001
000000000100000101010001
000000000100000101100001
000000000100001000000111
000000000100001000010011
000000000100001000100011
000000000100001001000011
000000000100001001000101
000000000100001100000101
000000000100001100010001
000000000100010000000111
000000000100010000001101
000000000100010001000011
000000000100010001000101
000000000100010001001001
000000000100010010000101
000000000100010100000011
000000000100010100000101
000000000100010100001001
000000000100011000000011
000000000100011000000101
000000000100100000001101
000000000100100000011001
000000000100100001000101
000000000100100100000101
000000000100110000000101
000000000101000000010011
000000000101000100000011
000000000101001000000011
000000001000000010001011
000000001000000010001101
000000001000000010010101
000000001000000010100011
000000001000000010101001
000000001000000010110001
000000001000000011000101
000000001000000011001001
000000001000000100001011
000000001000000100010011
000000001000000100010101
000000001000000100100011
000000001000000100101001
000000001000000100110001
000000001000000101000101
000000001000000101010001
000000001000000110001001
000000001000000110010001
000000001000000110100001
000000001000000111000001
000000001000001000001011
000000001000001000100011
000000001000001010000011
000000001000001010001001
000000001000001100000011
000000001000001100001001
000000001000010000001101
000000001000010001000101
000000001000010010000101
000000001000010010001001
000000001000010100000101
000000001000010100001001
000000001000010100010001
000000001000100000001011
000000001000100000001101
000000001000100000101001
000000001000100001001001
000000001000100010000101
000000001000100010001001
000000001000100100000011
000000001000100100001001
000000001000110000000101
000000001000110000001001
000000001001000010000101
000000001001000100000011
000000001001000100000101
000000001010000000100011
000000001010000010000011
000000001010000100000011
000000001010001000000011
000000010000000100000111
000000010000000100001011
000000010000000100001101
000000010000000100010011
000000010000000100010101
000000010000000100011001
000000010000000100100011
000000010000000100100101
000000010000000100101001
000000010000000101000011
000000010000000101000101
000000010000001000000111
000000010000001000010011
000000010000001000010101
000000010000001000011001
000000010000001000100011
000000010000001000100101
000000010000001000101001
000000010000001001010001
000000010000001001100001
000000010000001010100001
000000010000001100000011
000000010000001100000101
000000010000001100010001
000000010000001100100001
000000010000001101000001
000000010000001110000001
000000010000010000001101
000000010000010000010011
000000010000010000010101
000000010000010000011001
000000010000010000100011
000000010000010000100101
000000010000010000110001
000000010000010001000011
000000010000010001000101
000000010000010001001001
000000010000010001100001
000000010000010100000011
000000010000010100000101
000000010000010100001001
000000010000010100010001
000000010000010100100001
000000010000010101000001
000000010000011000000101
000000010000100000001011
000000010000100000010011
000000010000100000010101
000000010000100000011001
000000010000100001001001
000000010000100001010001
000000010000100010000011
000000010000100010000101
000000010000100010001001
000000010000100100000011
000000010000100100000101
000000010000100100001001
000000010000100100010001
000000010000101000001001
000000010000110000000101
000000010000110000010001
000000010001000000010011
000000010001000000010101
000000010001000000100101
000000010001000000101001
000000010001000000110001
000000010001000001000011
000000010001000001001001
000000010001000001010001
000000010001000010000011
000000010001000010000101
000000010001000010010001
000000010001000100000011
000000010001000100000101
000000010001000100001001
000000010001000100010001
000000010001001000000011
000000010001001000001001
000000010001010000001001
000000010001100000001001
000000010010000001000101
000000010010000010000011
000000010010000100000101
000000010010000100001001
000000010010001000000101
000000010100000010000101
000000010100000100000011
000000011000000100000011
000000100000010000010011
000000100000010000010101
000000100000010000100011
000000100000010000100101
000000100000010001000101
000000100000100000100011
000000100000100000101001
000000100000100010000011
000000100000100010001001
000000100000100100000011
000000100000100100100001
000000100000101000001001
000000100000101000100001
000000100001000001000011
000000100001000001010001
000000100001000010010001
000000100001000100000011
000000100001000100000101
000000100001000100001001
000000100001000100010001
000000100001001000000101
000000100001001000010001
000000100001010000010001
000000100010000010000011
000000100010000100000101
000000100010000100001001
000000100010001000001001
000000100100000100000101
