0001101111111111111111110111111110110111111101111
0001110011111111011011111110111111111111111111111
0001110111111101111111111111110110111111011111111
0010101111101111110111110111111111111111011111111
0010101111111111011111011111111111111111010111111
0010110111011110111111101111111111011111111111111
0010110111111111110111011111111111111111100111111
0010111011101111111111101111111101111011111111111
0010111011110111111101110111111111011111111111111
0010111011111110111101111011111111111111101111111
0010111100111111111111111110111111111011101111111
0010111101110111101110111110111111111111111111111
0010111101111111111111111011011111011101111111111
0010111110111111111011111111110110111111111110111
0010111111001110111111111111111110111110111111111
0010111111111111011101111111011111111101111011111
0010111111111111111111110111110111010111101111111
0011010111111011111110111111111011111110111111111
0011010111111111111111011111110111111010111111111
0011011010111111111011011111111110111111111111111
0011011101111111111111101111111110101111111101111
0011011110111111011111010111111111111110111111111
0011011111010111101111111111111101110111111111111
0011011111011111010111101111101111111111111111111
0011011111110111111111111111010111111111111001111
0011011111111011110101110111011111111111111111111
0011011111111111101111111111110101111111110101111
0011011111111111110111111110101111111011111101111
0011101011111111011011110111101111111111111111111
0011101111101011111101111111111110110111111111111
0011101111111110101111101101110111111111111111111
0011101111111111111111101111110110101111101111111
0011110111111111101101111111111111111101010111111
0011111010110111111111011101111111111101111111111
0011111011101111111111101111111111110110101111111
0011111011101111111111110110101111111111101111111
0011111011110111010111111101101111111111111111111
0011111101011011111111110111010111111111111111111
0011111101101111111111111111111101101011101111111
0011111101110111110110101111111111111011111111111
0011111101111101110101101111111111111110111111111
0011111110111111111111101011011101111101111111111
