000000000100001000000000100001000100001100011
000000000100001000100000100001000000001100011
000000000100001000000001100001000100000100011
000000000100001000100001100001000000000100011
000000000100001000000000100001001000010100101
000000000100001001000000100001000000010100101
000000000100001000000010100001001000000100101
000000000100001001000010100001000000000100101
000000000100001000000000100001010000100101001
000000000100001010000000100001000000100101001
000000000100001000000100100001010000000101001
000000000100001000000000100001100001000110001
000000000100001100000000100001000001000110001
000000000100001000001000100001100000000110001
000000000100001000100000100011000000001100001
000000000100001001000000100101000000010100001
000000000100001000000001100011000100000100001
000000000100001000000010100101001000000100001
