0000000001000101
0000000100000011
0000000100000101
0000000100001001
0000000100010001
