0000000110000001010110101010001011101111111
0000001011001000110000101000110101101111111
0000100100100001010110101010000110101111111
0000010111000110100011001001010000101111111
0000001100001011001100101010110001001111111
0000100001000110010101001100101001110111111
0000111000100101010001010010001001110111111
0000011100010000111011001001000011010111111
0000100100101101010100010000111001100111111
0000010101000001100110110101100001100111111
0000010101001001100100110101100001100111111
0000100010001110000110010101010110100111111
0000100010001110100110000101010110100111111
0000110001000101010100101110010100100111111
0000101100011101000101011000101000100111111
0000011010010000101010100100011001111011111
0000010011010100001001011001101100011011111
0000000011001000110010100111010011101011111
0000100011001000110010100111010010101011111
0000100010001100101101101001110000101011111
0000010001010011100100001101010111001011111
0000000011001010110010100111010011001011111
0000100011001000110010100111010011001011111
0000100011101000110000100111010011001011111
0000101011001000011100011001000101110011111
0000010010001000100011010101111010110011111
0000001001100110000110010101011011010011111
0000000100111011110001010101000011010011111
0000100110101011001011011000100001010011111
0000010101001001100110110101100001100011111
0000000100100011011001011001111010100011111
0000100100001001011110101010011010100011111
0000000100100011011101011001110010100011111
0000000100101011011001011001110010100011111
0000010110001010001001100101010001111101111
0000010110001010011000100101010001111101111
0000010001011001000101000010111100111101111
0000001000000111011011001011010110001101111
0000000110110010001000011010110011110101111
0000100001000110010101001101101001110101111
0000100001000110010101101100101001110101111
0000100111100110001001000101010001110101111
0000100100111000110100010001101011010101111
0000100101111000100010011010010011010101111
0000100001000110010101101101101001010101111
0000010101000001100110110101100011100101111
0000100010001110100110000101110110100101111
0000100010001110100110010101010110100101111
0000010101111000100010011010011010100101111
0000100010001110100110010111010010100101111
0000011001101111011010010001010001000101111
0000000101110001001100100110101010111001111
0000010010001110000011010101101110011001111
0000100011001100100011010011001011101001111
0000000010011010011010111100010110101001111
0000100101011110101100100110100010001001111
0000000110001111010111110100100010001001111
0000001100100100010000100111111101110001111
0000001100100100010000110111111100110001111
0000001110100100010000010111111100110001111
0000001100100100010000110111111101010001111
0000011100100100010000110111111100010001111
0000100011010000110010011111011100010001111
0000000100100011011101011001111010100001111
0000000100111000101011011110011011000001111
0000001110011001000001001010111100101110111
0000001110011001000001011010111000101110111
0000010001000011111001011001010110001110111
0000001010110100100001100100100111110110111
0000101100100011100101001001010100110110111
0000011000101001111010001110010010010110111
0000100001100100110111010110010101000110111
0000011001000010101100011111011010000110111
0000001001001111001110010101110100000110111
0000001001011111001110010101100100000110111
0000011101001000101100100001001101111010111
0000101001100001100101111100100011001010111
0000000010110010010111001110010101110010111
0000001010010010010111001110010101110010111
0000000010110010110011001110010101110010111
0000001101010011011010001000111001110010111
0000000010010111100110010101110001110010111
0000001101010100100000101011111010110010111
0000000111000110101111100101001000110010111
0000011000011011011000100011101101010010111
0000100001000010111011101100011110010010111
0000010110010100100010001111101110010010111
0000010010101011110010000110110101100010111
0000010011101011110010000110100101100010111
0000010011101011110010001100100101100010111
0000001010111011011010110001100001100010111
0000011001110111110100100010010010100010111
0000100011111001001010010110011100100010111
0000001000101010111100111011001011000010111
0000001001101010111100111001001011000010111
0000001001111010101100111001001011000010111
0000001001111010111000111001001011000010111
0000100011010101110110011101001001000010111
0000001010010110011100111110100110000010111
0000100010111001000100101101000101111100111
0000000001000101011110010010111011011100111
0000110000110101001000101000101111101100111
0000110101001000100101001000101111101100111
0000000011010100100010001011111011101100111
0000110000110101001000101100101101101100111
0000110101001000101101001000101101101100111
0000001001011001100111110100010100101100111
0000100010010100100010101011111011001100111
0000100011010100100010001011111011001100111
0000110001010100100010001011111011001100111
0000110010010100100010001011111011001100111
0000001101010100100000110101111101001100111
0000101001011110110110001010100100001100111
0000101010010001101100100010100111110100111
0000011011011001000010001100101011110100111
0000100001000110010101111100101001110100111
0000000101100100101110011100101011100100111
0000000001010111100101110010110011100100111
0000000110101001001000101101111101100100111
0000100110101001001000101101101101100100111
0000001101011100110100010110110010100100111
0000001000011101111001101010110010100100111
0000000101001110110110010100111101000100111
0000010111100101001000101101110010011000111
0000010110010011111001010110010100011000111
0000010110001000111111011010010100011000111
0000010010111110010011010101100100011000111
0000010010110111010001100010100111101000111
0000000010011100110100111101010011101000111
0000001011100001000001111011111110001000111
0000010011100100100001111001111110001000111
0000100001100100010011111011101110001000111
0000011010011001001010110111001110001000111
0000101011011110100110110000110010001000111
0000100011011001000101001011101011110000111
0000001101010100001000101011111110110000111
0000000101010101100011011010110110110000111
0000001101010100101000101011111010110000111
0000100011011001000101001111101011010000111
0000010010100100100101011101111101010000111
0000011010100010001000011111000110101111011
0000101000110100100110010101010100101111011
0000011010001100110010111000101001001111011
0000010010100110011100011100010110001111011
0000010110000100011000010111100101110111011
0000011001010111000010100011000110110111011
0000010110010100011000010111100100110111011
0000000001100101011100101101011100010111011
0000000010110001001110100110100111100111011
0000011000010110101100011110100010100111011
0000010010011011000110000101101111000111011
0000010110010001000101101011010111000111011
0000011011011110100010000101010011000111011
0000011010001101110010111000101001000111011
0000010010100110011101011100010110000111011
0000001011100110000100000111101010111011011
0000001000100101010111110100011100011011011
0000010000101100010111110010101001101011011
0000000110011010011101101101000010101011011
0000100010001100101101101001110100101011011
0000000100110111111001110001010100001011011
0000011010100100001000101011111001110011011
0000101001000101000101101101111000110011011
0000010101101000011111011100010000110011011
0000010110100001100011010101011011100011011
0000100101110011001010101110000110100011011
0000011010100100010100110111101011000011011
0000010101001101111010010111000011000011011
0000000110010011101010010111100100011101011
0000101000100011011011100001101011001101011
0000101100100011101011001000100011110101011
0000100011000010111100100100111011010101011
0000100001001011001111001011100011010101011
0000001100000110101111111010001010010101011
0000001100100110101111101010001010010101011
0000100001100100100111110110111000100101011
0000010001001111110100101100011101000101011
0000101000110101110100010110001001111001011
0000010111010001101011110110001000011001011
0000011001101000010101001110001111101001011
0000101110010001001101010111000111001001011
0000101010010100010001111101110011001001011
0000000100101110011101010110011101001001011
0000000010111001011101110011100101001001011
0000011001101000010101001110001111110001011
0000001011101000001100011101101111010001011
0000100011000010111100100110111011010001011
0000100110110001000111011110100101010001011
0000100101000111101110100101100110010001011
0000110010001001111111110010000110010001011
0000100011110101001001001111010011100001011
0000010001010111111011000111010100100001011
0000000110001000101111001011010100111110011
0000000001011101001011110100001101011110011
0000010001011100011011101010000101101110011
0000100101010000101101111010110100001110011
0000010101000011111100011000011010110110011
0000001011101111100001011010100000110110011
0000001001001111001110010101110100010110011
0000001001011110001110010101110100100110011
0000001001011111001110010101110100000110011
0000000101010100111011110000110011011010011
0000010011110110010101110000101100011010011
0000010100011001011111100100011101001010011
