000000000100010010011
000000000100100010011
000000001000010101001
000000001001010000101
000000010000011100001
000000010000110000011
000000100000010000111
000000100000010010011
000000100000010010101
000000100000100000111
000000100000110000011
000000100000110000101
000000100000110010001
000000100001000010101
000000100001010000011
000000100001010000101
000000100001010010001
000000100010001001001
000000100010010001001
000000100100010000011
000000100100010000101
