00011011111
00101011111
00101110111
00101111011
00110101111
