00000101010101010001010001000101010001010101010101
00000101010101000100010100010101000101010101010101
00000101010101000100010001010001010101010101010101
00000101010100010100010101000100010101010101010101
00000101010100010100010001000101010101010101010101
00000101010100010001010100010100010101010101010101
00000101010001010001010101010001000101010101010101
00000101010001010001000101010001010101010101010101
00000101010001000101010101010001010001010101010101
00000101010001000101010101000101000101010101010101
00000101010001000101000101010101010100010101010101
00000101000101010101010101010101000100010001010101
00000101000101010101010101010001010100010001010101
00000101000101010101010101010001010001000101010101
00000101000101010101010100010101010101000100010101
00000101000101010101010100010101010001000101010101
00000101000101010101000101010100010001010101010101
00000101000101010101000100010101010001010101010101
00000101000101010100010001010101010001010101010101
00000101000101010001010101010101010100010001010101
00000101000101010001000101010101010101010100010101
00000101000101000101000100010101010101010101010101
00000101000101000100010101010001010101010101010101
00000101000100010101010101010101010001000101010101
00000101000100010101010101010101000100010101010101
00000101000100010101010101010100010100010101010101
00000101000100010101010101010001010101010101000101
00000101000100010101010101000001010101010101010101
00000101000100010101010100010101010101010101000101
00000101000100010101010001010101010001010101010101
00000101000100010101000101010101010100010101010101
00000101000100010101000101010101010001010101010101
00000101000001010101010001000101010101010101010101
00000101000001010101000100010101010101010101010101
00000100010101010101010101010100010101000001010101
00000100010101010101010101010100010001010101000101
00000100010101010101010101010100010001010100010101
00000100010101010101010101010001010100000101010101
00000100010101010101010101000101010001010001010101
00000100010101010101010100010101010100010100010101
00000100010101010101000101010101010001010101000101
00000100010101010101000101010001010101010001010101
00000100010101010100010101010101000101010001010101
00000100010101010100010101010100010101010100010101
00000100010101010100010101010001010100010101010101
00000100010101010100010101000101010101010001010101
00000100010101010100010001010101010101010100010101
00000100010101010100000101010101010101010100010101
00000100010101010100000101010001010101010101010101
00000100010101010001010101010101000101010101000101
00000100010101010001010101010100010101000101010101
00000100010101010001010101000101010101010101000101
00000100010101010001010100010101010101010101000101
00000100010101010001010100010101010100010101010101
00000100010101010001000101010101010101010101000101
00000100010101010001000101010001010101010101010101
00000100010101000101010101010101010001010001010101
00000100010101000101010101010100010101010101010001
00000100010101000101010100010101010100010101010101
00000100010101000101010100010101010001010101010101
00000100010101000101010100010100010101010101010101
00000100010101000101010001010101010101010101010001
00000100010101000101010001010101010101010001010101
00000100010101000101010001010101000101010101010101
00000100010101000101010000010101010101010101010101
00000100010101000101000101010100010101010101010101
00000100010100010101010101000101010001010101010101
00000100010100010101000101010001010101010101010101
00000100010100000101010101010100010101010101010101
00000100010001010101010101010101010100000101010101
00000100010001010101010101000101010101000101010101
00000100010001010101010100010101010101010101000101
00000100010001010101010100010101010101010001010101
00000100010001010101010100010101010100010101010101
00000100010001010101010000010101010101010101010101
00000100010001010100010101010101000101010101010101
00000100010001000101010101010101010001010101010101
00000001010101000101000101010001010101010101010101
00000001010100010101010101010101000101000101010101
00000001010100010101010101010100010100010101010101
00000001010100010101000101000101010101010101010101
00000001010100010100010101010100010101010101010101
00000001010100010100010100010101010101010101010101
00000001010001010101010101010101010001000101010101
00000001010001010101010100010101010100010101010101
00000001010001010101010001010101010100010101010101
00000001010001010100010101010100010101010101010101
00000001000101010101010100010101010101010001010101
00000001000101010100010101010100010101010101010101
00000000010101010001010100010101010101010101010101
