00000000000100010101
00000000000101000101
00000000010000010101
00000000010001000101
00000001000001000101
00000001000001010001
00000001000100000101
00000001000100010001
