000000000010000000000100000000111
000000000010000000001000000000111
000000000000000100000010000001011
000000000010000000000100000100011
000000000000000100000100001000011
000000000010000000000100001000011
000000000000000100001000001000011
000000000001000010000000100000011
000000000010000000000101000000011
000000000001000000001100000000011
000000000010000000001100000000011
000000000010000000010100000000011
000000000010000010000100000000011
000000000010000100000100000000011
000000000010100000000100000000011
000000000000100100010000000000011
000000000000000000001000010010101
000000000010000000000100000010101
000000000010000000010000000010101
000000000000010000100000000010101
000000000010000000000100010000101
000000000010000000001100000000101
000000000000100000010100000000101
000000000010000000010100000000101
000000000010000001000100000000101
000000000010001000000100000000101
000000000000000000010000100011001
000000000010000000000100000011001
000000000010000000000100000101001
000000000010000000000100001001001
000000000001000000001000001001001
000000000010000000100000001001001
000000000000001000000100010001001
000000000010000000000100010001001
000000000000001000100000010001001
000000000000010000100100000001001
000000000010000000100100000001001
000000000010000001000100000001001
000000000010000010000100000001001
000000000010000100000100000001001
000000000010001000000100000001001
000000000000010000000000001110001
000000000010000001000000100010001
000000000010000000010100000010001
000000000010000000100100000010001
000000000010000001000100000010001
000000000000000000100000011100001
000000000000010000000100100100001
000000000010000010000010000100001
000000000010000000001100000100001
000000000010000000100100000100001
000000000010000010000100000100001
000000000100000000100010001000001
000000000010000000001100001000001
000000000010000000100100001000001
000000000000100000000101010000001
000000000010000000010100010000001
000000000010000000100100010000001
000000000100000001010000010000001
000000000001000000000111000000001
000000000010000000001101000000001
