000110111110111111
000111011011111111
001011011101111111
001011110111011111
001011111011110111
001011111101111011
001101101011111111
001101111110101111
001110101101111111
