000000000001001010111
000000000001001101011
000000000001010011101
000000000001100101011
000000000010001001111
000000000010001111001
000000000010100011011
000000000010110001011
000000000011001001011
000000000011001010011
000000000100001101101
000000000100010001111
000000000100010100111
000000000100100011101
000000000100100100111
000000000100101000111
000000000100101001101
000000000101000100111
000000000101001001011
000000000101001001101
000000000101011000011
000000000101100000111
000000000101101000011
000000000110000101011
000000000110001010011
000000001000001011011
000000001000100111001
000000001000101001101
000000001000110010101
000000001000110100011
000000001001000101011
000000001001000110101
000000001001001010011
000000001001010001011
000000001001100001101
000000001010001010011
000000001010010001101
000000001010010010011
000000001010110000011
000000001011000010011
000000001011001000011
000000001100000101011
000000010000001110101
000000010000010101011
000000010000010111001
000000010000011001101
000000010000110010101
000000010001000001111
000000010001000011011
000000010001000011101
000000010001001001011
000000010001001011001
000000010001001101001
000000010001011000101
000000010001101000101
000000010010000010111
000000010010000110011
000000010010000111001
000000010010001010011
000000010010011000101
000000010100100100011
000000010101010000011
000000010110100000011
000000100000010001111
000000100000010101011
000000100000010110011
000000100000110001101
000000100000110101001
000000100000110110001
000000100001000011011
000000100001001001101
000000100001001101001
000000100001010001011
000000100001011001001
000000100001011010001
000000100001100100011
000000100001101010001
000000100001110001001
000000100010000010111
000000100010001100101
000000100010010000111
000000100010010100011
000000100010011000101
000000100010100001011
000000100010100100011
000000100010110000101
000000100011000001101
000000100011000010011
000000100011000011001
000000100011001000011
000000100011010000011
000000100011100000101
000000100011100001001
000000100100001100101
000000100100010100011
000000100100011000101
000000100101000100011
000000100110000100101
000000101000001100011
000000101000010001011
000000101000010010011
000000101000100100011
000000101010010000011
000000101100010000011
000001000001000011011
000001000001000011101
000001000001000101101
000001000001000111001
000001000001001010011
000001000001001100101
000001000010000100111
000001000010000101101
000001000010010001011
000001000010010010101
000001000010011100001
000001000010100010011
000001000010100100011
000001000010110001001
000001000011000100011
000001000011010001001
000001000100000101101
000001000100001001101
000001000100001100101
000001000100001101001
000001000100010100101
000001000100010101001
000001000100100001011
000001000100100010101
000001000101100001001
000001000110010000101
000001000110100001001
000001001000001010011
000001001000010001011
000001001000010100011
000001001000010100101
000001001000011000101
000001001000100001011
000001001000100001101
000001001000101000011
000001001001001001001
000001001010000011001
000001001010001000101
000001001100010000101
000001010000100100011
