000000000000000000000001011
000000000000000000000010011
000000000000000000001000011
000000000000000000010000011
000000000000000001000000011
000000000000000010000000011
000000000000001000000000011
000000000000010000000000011
000000000000000000000100101
000000000000000000001000101
000000000000000000100000101
000000000000000001000000101
000000000000000100000000101
000000000000001000000000101
000000000000100000000000101
000000000000000000010001001
000000000000000000100001001
000000000000000001000001001
000000000000000010000001001
000000000000000100000001001
000000000000001000000001001
000000000000010000000001001
000000000000100000000001001
000000000000000001000010001
000000000000000010000010001
000000000000001000000010001
000000000000010000000010001
000000000001000000000010001
000000000000000100000100001
000000000000001000000100001
000000000000100000000100001
000000000001000000000100001
000000000000010000001000001
000000000000100000001000001
000000000001000000001000001
000000000010000000001000001
000000000001000000010000001
000000000010000000010000001
000000000100000000100000001
