000000000001010010010010111001001001111
000000000001101001001001110100100100111
000000000010100110000111010011000011101
000000000011000100100101110010010010111
000000000011001001011001001011001001011
000000000011100100100101100010010010111
000000000100001001010111010000101011101
000000000100100110001010110011000101011
000000000100101000110011010100011001101
000000000101001001101001001101001001101
000000000101010000110010111000011001011
000000000101100110001010010011000101011
000000000101110000110010101000011001011
000000000101110010010000111001001001011
000000000101110010010010111001001000011
000000001000011111000100001111100010001
000000001000100001111100010000111110001
000000001001011001001010001011001001011
000000001001100001110101000000111010011
000000001001101001001100001101001001101
000000001001110010110000011001001010011
000000001010000001100101110000110010111
000000001010010010011010010011010010011
000000001010010011010010010011010010011
000000001010010011010010011010010010011
000000001010100001100101100000110010111
000000001010100110000011010011000011101
000000001010100110000111010011000001101
000000001011000001100101010000110010111
000000001011000100100001110010010010111
000000001011000100100101110010010000111
000000001011001000010100110101001000111
000000001011100001100101000000110010111
000000001011100100100001100010010010111
000000001011100100100101100010010000111
000000010000100001011101010000101110101
000000010000110100001010111010000101011
000000010001001001011001001011001001011
000000010001001011001001001011001001011
000000010001001011001001011001001001011
000000010001001011001001011001001011001
000000010001011100001000111110000100011
000000010001101001000001110100100100111
000000010001101001001001110100100000111
000000010001110100001010011010000101011
000000010001110100001010111010000101001
000000010001111100001000101110000100011
000000010010000011001101010001100110101
000000010010011010010001010011010010011
000000010010100001011100010000101110101
000000010010100011001101000001100110101
000000010010111000010001011100001100101
000000010010111000011001011100001000101
000000010011101001000000110100100100111
000000010011101001000001110100100100011
000000010011101001001000110100100000111
000000010011101001001001110100100000011
000000010100100110000010110011000101011
000000010100100110001010110011000001011
000000010100110100001000111010000101011
000000010100110100001010111010000100011
000000010101100110000010010011000101011
000000010101100110001010010011000001011
000000010101110100001000011010000101011
000000010101110100001010011010000100011
000000011001001001001010001001011001011
000000011001011001001010001001001001011
000000100000100100111001010010011100101
000000100000110010010100111001001010011
000000100001001000010101110100001010111
000000100001001001101001001101001001101
000000100001001101001001001101001001101
000000100001001101001001101001001001101
000000100001001101001001101001001101001
000000100001101000010101100100001010111
000000100001110010000010111001001001011
000000100001110010010010111001000001011
000000100001110010010100011001001010011
000000100001110010010100111001001010001
000000100010011000010001111100001000111
000000100010100100111000010010011100101
000000100010101000110011010110010001001
000000100010111000001001011100001100101
000000100010111000010001101100001000111
000000100010111000011001011100000100101
000000100011001000010100110100001010111
000000100011001000010101110100001010011
000000100011011000010001011100001000111
000000100011011000010001111100001000101
000000100011101000010100100100001010111
000000100011101000010101100100001010011
000000100011111000010001001100001000111
000000100011111000010001101100001000101
000000100100010001010110011000101011001
000000100100101000100011010100011001101
000000100100101000110011010100010001101
000000100100101100100001100101100100101
000000100100110001010110001000101011001
000000100101010000100010111000011001011
000000100101010000110010111000010001011
000000100101110000100010101000011001011
000000100101110000110010101000010001011
000000100101110010000010111001001000011
000000100101110010010000111001000001011
000000100110101000100010010100011001101
000000100110101000110010010100010001101
000000101000100001110100100000111010011
000000101000110010010000111001001010011
000000101000110010010100111001001000011
000000101001000001110100010000111010011
000000101001001000010001110100001010111
000000101001001000010101110100001000111
000000101001001001001100001001101001101
000000101001101000010001100100001010111
000000101001101000010101100100001000111
000000101001101001001100001001001001101
000000101001101010000101100100001000111
000000101001110010010000011001001010011
000000101001110010010100011001001000011
000000101011001000010000110100001010111
000000101011001000010001110100001010011
000000101011001000010100110100001000111
000000101011001000010101110100001000011
000000101011101000010000100100001010111
000000101011101000010001100100001010011
000000101011101000010100100100001000111
000000101011101000010101100100001000011
000001000001000011011001001001001011011
000001000001000100101001110010010100111
000001000001000101101001001001001101101
000001000001001011011001001001001010011
000001000001001101101001001001001100101
000001000001010011001001001001001011011
000001000001011011001001001001001010011
000001000001100100101001100010010100111
000001000011000100000101110010010010111
000001000011000100100101110010000010111
000001000011000100101000110010010100111
000001000011000100101001110010010100011
000001000011000101101001110010000100011
000001000011010000100011011100010001011
000001000011010001001001001001011011001
000001000011010001001001001011011001001
000001000011011001001001001001011010001
000001000011100100000101100010010010111
000001000011100100100101100010000010111
000001000011100100101000100010010100111
000001000011100100101001100010010100011
000001000100010000100011111000010001111
000001000100101000010011010100011001101
000001000100101000110011010100001001101
000001000100101001110000010100111001001
000001000100110000100011101000010001111
000001000101010000010010011000011101011
000001000101010000010010111000011001011
000001000101010000100011011000010001111
000001000101010000100011111000010001101
000001000101010000110010111000001001011
000001000101100001001001001001101101001
000001000101100001001001001101101001001
000001000101110000010010101000011001011
000001000101110000100011001000010001111
000001000101110000100011101000010001101
000001000101110000110010101000001001011
000001000110000100100111010010000011101
000001000110010000100010111000010001111
000001000110010000100011111000010001011
000001000110100100000111000010010011101
000001000110101000010010010100011001101
000001000110101000010010010110011000101
000001000110101000010011010100011001001
000001000110101000110010010100001001101
000001000110101000110011010100001001001
000001000110110000100010101000010001111
000001000110110000100011101000010001011
000001000110111000100001101000010001011
000001000111010000100010011000010001111
000001000111010000100010111000010001101
000001000111010000100011011000010001011
000001000111010000100011111000010001001
000001000111110000100010001000010001111
000001000111110000100010101000010001101
000001000111110000100011001000010001011
000001000111110000100011101000010001001
000001001000001001011001010001011001011
000001001000001001101001100001101001101
000001001000011001011001010001011001001
000001001000100010101100100001010110011
000001001000101001101001100001101001001
000001001000110010100000111001010010011
000001001000110010100100111001010000011
000001001001000001001001000011011011011
000001001001000001001001000101101101101
000001001001000001001001001010011011011
000001001001000001001001001100101101101
000001001001000001001001010011011011001
000001001001000001001001011010011011001
000001001001000001001001100101101101001
000001001001000001001001101100101101001
000001001001000010101100010001010110011
000001001001000011011011010001001001001
000001001001000101101101100001001001001
000001001001001000001001001010011011011
000001001001001000001001001100101101101
000001001001001000001001011010011011001
000001001001001000011001010001011001011
000001001001001000011001011001010001011
000001001001001000101001100001101001101
000001001001001000101001101001100001101
000001001001001010001011000011001011001
000001001001001010001011001011000011001
000001001001001011011001001000001010011
000001001001001100001101000101001101001
000001001001001100001101001101000101001
000001001001001101101001001000001100101
000001001001011000011001010001011001001
000001001001011001000010001011001001011
000001001001101001000100001101001001101
000001001001110010100100011001010000011
000001001010000100100011110010000010111
000001001010001001000011001001001011011
000001001010001001000011011001001001011
000001001010001001001011001001000011011
000001001010001001001011011001000001011
000001001010011001000001011001001001011
000001001010011001001001011001000001011
000001001010100001000101100000110010111
000001001010100001000101100000111010011
000001001011000001100101010000100010111
000001001011000001100101110000100010101
000001001011000100100001110010000010111
000001001011001001001010001001000011011
000001001011001001001010011001000001011
000001001011001001010000011001001011001
000001001011011001001000011001000001011
000001001011100001000101100000110010101
000001001011100100000101100010010000111
000001001011100100000111000010010001101
000001001100001001000101001001001101101
000001001100001001000101101001001001101
000001001100001001001101001001000101101
000001001101001001001100001001000101101
000001010001000100100001110010010100111
000001010001000100101001110010010000111
000001010001100100100001100010010100111
000001010001100100101001100010010000111
000001010001100101001001100010010000111
000001010011000100100001110010010100011
000001010011000100101000110010010000111
000001010011100100100001100010010100011
000001010011100100101000100010010000111
000001011000100010100100100001010110011
000001011000100010101100100001010010011
000001011001000010100100010001010110011
000001011001000010101100010001010010011
000001011001000110101000010001010010011
000001011001001001000010001001011001011
000001011001011001000010001001001001011
