00000000000000010111
00000000000000100111
00000000000001001101
00000000000001010011
00000000000010001011
00000000000010001101
00000000000010100011
00000000000100000111
00000000000100001101
00000000000100010011
00000000000100010101
00000000000100011001
00000000000100100011
00000000000101000011
00000000000101000101
00000000001000001011
00000000001000010011
00000000001000100101
00000000001000101001
00000000001001000011
00000000001001000101
00000000001010000011
00000000010000000111
00000000010000010101
00000000010000011001
00000000010001000011
00000000010001000101
00000000010001001001
00000000010010000101
00000000010100000011
00000000100000001011
00000000100000010101
00000000100000011001
00000000100000100011
00000000100000101001
00000000100001001001
00000000100001010001
00000000100010000101
00000000100010001001
00000000100100000101
00000000101000000011
00000001000000010011
00000001000000100011
00000001000000100101
00000001000000110001
00000001000001000101
00000001000001001001
00000001000001010001
00000001000010000011
00000001000010001001
00000001000100000011
00000001000100000101
00000001000100001001
00000001000100010001
00000010000001000011
00000010000001000101
00000010000010000011
00000010000010001001
00000010000100000101
00000010000100010001
00000010001000001001
