00000000000000000001001010111
00000000000000000001001101011
00000000000000000100010001111
00000000000000001010110000011
00000000000000010101100000011
00000000000000101100010000011
00000000000001000001100101001
00000000000001000101100001001
00000000000001001000010001101
00000000000001001000100010011
00000000000001010001000100101
00000000000001100000000101011
00000000000001100000101000011
00000000000010000101000001011
00000000000010010000010001011
00000000000010010001000100011
00000000000100000001001101001
00000000000100000001010001101
00000000000100000010010010011
00000000000100001001010000101
00000000000100001100000100011
00000000000100010000000001111
00000000000100010000001001011
00000000000100010000001011001
00000000000100100000000010111
00000000000100100000101000011
00000000000101000010001000101
00000000001000000011110000001
00000000001000000100011000011
00000000001000001000100010101
00000000001000001010001000101
00000000001000001010001100001
00000000001000010001100001001
00000000001000100000001110001
00000000001000111000000001001
00000000001010000010001000011
00000000010000000101001100001
00000000010000100010100001001
00000000010000100100010000011
00000000010000110000001000101
00000000010001100010000000011
00000000010010000100000101001
00000000100000000101100000011
00000000100000001000000110011
00000000100000001000010001101
00000000100000010000001010101
00000000100000010001000001011
00000000100000010010010000011
00000000100000100000100100101
00000000100000100100010000101
00000000100000110000000100101
00000000100001010001000000101
00000000100010000010000100011
00000000100100000100000100101
00000000101000000010010000011
00000001000000010000001010101
00000001000000010000001101001
00000001000000010000010011001
00000001000000010000011100001
00000001000000010000100010011
00000001000000100000010000111
00000001000000100000010011001
00000001000000100001000101001
00000001000000101000010000101
00000001000001100010000001001
00000001000001101000000100001
00000001000010000100001001001
00000001000010010001000010001
00000001000100000010010000011
00000001000100001000000100101
