000111001001011101101010011110110111011011111111
000110111111110101110111010100100101101110011111
000110111111010100101100111010110011111110011111
000110111110010010100101110101111011110111011111
000110100101110101111110110101011110110011111011
000101111110110111111010110011011101010110100111
000101111101001011100110011010011111011111111011
000101110101101001111001100111011011111101011111
000101110001111101111101100111011111101001011011
000101100101101111011000111011111101111010111101
000101010011101101011011110011111101101101111101
000101001111011011001111110011111101011011110101
000101001001101111110111101011111110001110111101
000100111000101001101111101011010111101111111111
000100110111110010011010111110101101111110101111
000100110111100110101111010111111101111100010111
000100110101111111011111010110101111100100110111
000100100111110100011101110011111010110111111111
000010011101111000110010111110100111111110111111
000010011101110100111110111100110011111110101111
000010001110101111010011101101111101101101111111
000001111011101010100100111011111111011011011111
000001101101111011000111111011011111011101010111
000001011100101110110111101111101011001111111101
