000110111011111111110111110111111111011111111111
000110111111111101111101111111111111111100111111
000111011011111110111111110111111111011111111111
000111011111111111111011011111111111110110111111
001001110111111111101111101111111111111011111111
001010111110111011111111011111101111111111111111
001010111110111110111111011111111011111111111111
001010111111111011111111011111111110111110111111
001010111111111111111111011111101111101011111111
001011101011111111101111011111111110111111111111
001011101111111111111111011110111111101011111111
001011101111111111111111011111111010111111101111
001011101111111111111111111011110111101101111111
001011110111111011101111101101111111111111111111
001011110111111011111011101111111111111101111111
001011111011111111101111011111101110111111111111
001011111011111111101111011111111111101110111111
001011111011111111111110111111110011111111110111
001011111110111010111111011110111111111111111111
001011111110111011111111011111111111111110101111
001011111110111110111111011110111011111111111111
001011111111101010111111011111111111111111101111
001011111111101011101111011111111111111110111111
001011111111101110111111011111111011111111101111
001011111111111011101111011111111110111110111111
001011111111111110111111011111111011101111101111
001011111111111111101111011111111110111010111111
001011111111111111110111111001111011101111111111
001011111111111111111111011110101110111011111111
001011111111111111111111011110111010111110111111
001100111111110101111101111110111111111111111111
001101011011110111111111111111011111101111111111
001101011101110111111111111111011111101111111111
001101011111101111111011111111011111110111111111
001101011111101111111111011111110101111111111111
001101011111101111111111111101011111110111111111
001101011111101111111111111111011011110111111111
001101011111101111111111111111011101110111111111
001101011111110101111111101111110111111111111111
001101011111110111111011111111011111101111111111
001101011111110111111111101111110111111101111111
001101011111110111111111111101011111101111111111
001101011111111101111011111111011111111110111111
001101011111111111011111101111111111110101111111
001101110101110111111111111111110111101111111111
001101110110111111111110101111111111111111101111
001101110111101111111111111111110101110111111111
001101110111111011111111101011111111111111101111
001101110111111110101111111110111111111111101111
001101110111111111101011111111111011111111101111
001101111001111111111101011111111111111110111111
001101111010111011111111111001111111111111111111
001101111010111111111111011111101111111111101111
001101111011111110111111111101011111111111011111
001101111101111111010111101111111111011111111111
001101111101111111111011111110111101011111111111
001101111101111111111111011111010111101111111111
001101111111011011111111101111111111111110101111
001101111111011110101111101111111111111011111111
001101111111101110101111011011111111111111111111
001101111111110101111111101111111111111111010111
001101111111110111010111101111111111111101111111
001101111111110111111111101111011111111101011111
001101111111111001111010111111111111111011111111
001101111111111010111111101111111111011111101111
001101111111111011111011111111111111101011110111
001101111111111101011111101111111111110111110111
001101111111111101111111101111010111110111111111
001101111111111111101111101111111111011010111111
001101111111111111110111101111111101011111011111
001101111111111111110111101111111111110101011111
001101111111111111111111101111010111110101111111
001110101111101111111011011111111111111011111111
001110101111111011111011011111111111101111111111
001110101111111011111111011011111111101111111111
001110101111111111101111111110110111111101111111
001110101111111111111111011011111110111011111111
001110110111111110101111111101111111111111101111
001110111011010111111111111111110111110111111111
001110111110111111111111011011111111111010111111
001110111111101011111011011111101111111111111111
001110111111110111110101101111110111111111111111
001110111111111110111111011011111010111111111111
001110111111111111111011011111101111101011111111
001110111111111111111111011101101111101011111111
001111010101111111111101101111111111011111111111
001111010101111111111101101111111111110111111111
001111010101111111111111011111111101101111111111
001111010111011111111101101111111111111101111111
001111010111111111111101101111111101110111111111
001111010111111111111111011101111101101111111111
001111011011101111111111011111110101111111111111
001111011101101111111111011111110101111111111111
001111011111110101011111101101111111111111111111
001111011111110101111111101101110111111111111111
001111011111111111011011101111111111110101111111
001111011111111111011101101111111111110101111111
001111011111111111111101101111111111110101011111
001111101110111011111111011010111111111111111111
001111101110111111101011011111111011111111111111
001111101110111111111111111111110110101101111111
001111110101101111111111011101011111111111111111
001111110101101111111111011111011101111111111111
001111110101101111111111111111110101110111111111
001111110101110110111111111111110111101111111111
001111110101110111111101101111011111111111111111
001111110101110111111111111110110111101111111111
001111110101110111111111111111110101101111111111
001111110110111010111111111111111111011110111111
001111110110111101111110101110111111111111111111
001111110111101111111111111110110101110111111111
001111110111111101110101101111111111110111111111
001111110111111111101110101101111110111111111111
001111111011110111111111111110110111010111111111
001111111101110111110101101111110111111111111111
001111111101111111111101101111010111011111111111
001111111101111111111111011111010101101111111111
001111111110111110101011011111111011111111111111
001111111110111111101111011011101011111111111111
001111111111011101111101101111010111111111111111
001111111111011111010101101111111101111111111111
001111111111101110101111011011111011111111111111
001111111111110101110101101111110111111111111111
001111111111110111110101101110110111111111111111
