000000000000000000011
000000000000000000101
000000000000000001001
000000000000000010001
000000000000000100001
000000000000001000001
000000000000010000001
000000000000100000001
000000000001000000001
000000000010000000001
