00000000000000011
00000000000000101
00000000000001001
00000000000010001
00000000000100001
00000000001000001
00000000010000001
00000000100000001
