00000000000000000100010101
00000000000000010000010101
00000000000100000000010101
00000000010000000001000101
00000000000100000100000101
00000000010000000100000101
00000000000100010000000101
00000000000001000001010001
00000000000100000100010001
00000000010000000100010001
00000000010000010000010001
00000000010000000101000001
