0000000001000110010010100111010011001
0000000010011010010100001010100011101
0000000100101000010001001100111100101
0000000110000010110110001000010101011
0000001000001011000011101110000010011
0000010001000011000011110000100110101
