000000000011001001011001001011
000000000101001001101001001101
000000000101010001010101010101
000000001010010010011010010011
000000001010010011010010010011
000000010001001001011001001011
000000010001001011001001001011
000000010001001011001001011001
000000010001010001010101010101
000000010001010101000101010101
000000010001010101010001010101
000000010001010101010100010101
000000010100010001010101010101
000000010100010100010101010101
000000010100010101000101010101
000000010100010101010001010101
000000010101000101000101010101
000000100001001001101001001101
000000100001001101001001001101
000000100001001101001001101001
000001000001000111000011000111
000001000001010101000101010101
000001000010110000011001110001
000001000011000001000111000111
000001000011000011000101000111
000001000011000101000111000011
000001000011000111000011000101
000001000011000111000101000011
000001000100001101000010100111
000001000100010001010101010101
000001000100010101000101010101
000001000100010101010001010101
000001000100010101010100010101
000001000100010101010101000101
000001000101000001010101010101
000001000101000011000011000111
000001000101000011000111000011
000001000101000101010001010101
000001000101000101010100010101
000001000101010000010101010101
000001000101010001010001010101
000001000101010001010100010101
000001000101010001010101000101
000001000101010001010101010001
000001000101010100010101000101
000001000101010101000100010101
000001000101010101010000010101
000001000101010101010001000101
000001000101010101010100000101
000001000111000011000011000101
000001000111000101000011000011
000001001000001001000011011011
000001001000001001000101101101
000001001000001001001010011011
000001001000001001001100101101
000001001000001001010011011001
000001001000001001011010011001
000001001000011011010001001001
000001001000101101100001001001
000001001001000001001010011011
000001001001000001001100101101
000001010001000100010101010101
000001010001000101000101010101
000001010001000101010100010101
000001010001000101010101000101
000001010001010001000101010101
000001010001010100010001010101
000001010001010101000100010101
000001010100010001010001010101
000001010100010100010001010101
