0000000001000000001100000001010000000111
0000000001000000011100000001010000000011
0000000001000000010100000100010000010101
0000000001000100000100000001010001000101
0000000001000001010100000100010000000101
0000000001000000100100010000010001001001
0000000001000100100100010000010000001001
0000000001000001000101000000010100010001
