0000000000000001101001001000100111
0000000000000010101001001001000111
0000000000000101001100011000001101
0000000000000110000101010001001011
0000000000000110010001000101001011
0000000000001000110001001001001101
0000000000001001000100010001111001
0000000000001001100011000010010101
0000000000001010100010010010000111
0000000000001010100011000010010011
0000000000001011000100010010000111
0000000000010000010100011011100001
0000000000010010000011000100110101
0000000000010011101001001000000011
0000000000010100000010011000110101
0000000000010100001001001000011101
0000000000010100100100011000001011
0000000000010101000000110000110011
0000000000011000101001000010001011
0000000000100000100000110001001111
0000000000100000100011000001111001
0000000000100000111110010000100001
0000000000100001000010000100011111
0000000000100001001000001000101111
0000000000100001101101000100000011
0000000000100001110010001000001011
0000000000100010000011000001101011
0000000000100010100000110001001011
0000000000100010100100101000000111
0000000000100010110100000001110001
0000000000100011101001001000000101
0000000000100100000011000101011001
0000000000100100000110000101010011
0000000000100100001010000011100011
0000000000100100101000110000001101
0000000000100101100000110001000101
0000000000100110100001000110000101
0000000001000000100000011001010111
0000000001000000100100001100010111
0000000001000001010000100011001101
0000000001000001100011001000010101
0000000001000001110101000010001001
0000000001000010011110000010000101
0000000001000011001001100000010101
0000000001000011100010010000010101
0000000001000100000001001001101011
0000000001000100001000011000011101
0000000001000100100000100100001111
0000000001000100110101000010000011
0000000001000110000100100000011101
0000000001001000000001101010001011
0000000001001000000011000010101011
0000000001001000000110000100110101
0000000001001000001110001010001001
0000000001001000010001010110000011
0000000001001001100011000000010101
0000000001001010100010010000000111
0000000001001010100011000000010011
0000000001001010101001100000000011
0000000001001011000100010000000111
0000000001010000000100001001100111
0000000001010001001010000100100011
0000000001010100100000011000010011
0000000010000000110000100101010011
0000000010000000110101011000000101
0000000010000010001000001110100101
0000000010000010001000101000011101
0000000010000010100100001110010001
0000000010000011001000100000101101
0000000010000011001010000100010011
0000000010000100000001100101010011
0000000010000100001000111010001001
0000000010000100011100000100110001
0000000010000100100010001011000011
0000000010000101001101010000001001
0000000010000101011100000100001001
0000000010001000010000100101110001
0000000010001000100100000011100101
0000000010001000100100001000011101
0000000010001000100100001110000101
0000000010001001000100001101000011
0000000010001001001010000100000111
0000000010001010000100100000011101
0000000010010000100000100010111001
0000000010010000110001001010000101
0000000010010001001101000001000011
0000000010100000001000000110011011
0000000010100001010001001000010011
0000000010100001100010001000001101
0000000010100100100110000000100011
0000000010101000110000100100000011
0000000010101100101000000100000011
0000000100000001010001000001101011
0000000100000010100000011001101001
0000000100000011000001001010100011
0000000100000011101001000000100011
0000000100000011101001000001000101
0000000100000100000100011110100001
0000000100000100100100010000101011
0000000100000100101000010000110011
0000000100000101100100010000101001
0000000100000101110010000001000011
0000000100000110010010000010010101
0000000100001000000010001101001101
0000000100001000000010010110010011
0000000100001000001110000001011001
0000000100001000100100000100011101
0000000100001001001000100000101011
0000000100001001011000001000010101
0000000100001010011000001000010011
0000000100001010100000100110000011
0000000100001100010101000000101001
0000000100001110100100000100010001
0000000100010000010100000110101001
0000000100010000100010000011100101
0000000100010001000001001010000111
0000000100010011010010000010000101
0000000100011100100000010100001001
0000000100100000010000001100011101
0000000100100000100001110100000011
0000000100100000110001110000000101
0000000100100000110010101000000011
0000000101000001000001000100101011
0000000101000001000001001000100111
0000000101100000100001000100001101
0000001000000100000010000010011111
0000001000000100000101000010001111
0000001000000100001000010001011101
0000001000000100001000101001001011
0000001000000100010110000100011001
0000001000000100100001000001110101
0000001000000100100100001000101011
0000001000000100101000100001001101
0000001000000100110100010000100011
0000001000001000001000001000110111
0000001000001000100010110000100101
0000001000001011100010000010000101
0000001000001100010001000001011001
0000001000010000010000010000101111
0000001000010000100000101110100001
0000001000010000110100010000001011
0000001000010001010000010000101101
0000001000010001010110010000001001
0000001000010001110100010000001001
0000001000010110010000010000100011
0000001000100001100000100001001101
0000001000100011100000100001001001
0000001000100100100000100001000111
0000001000100110100000100001000011
0000001001000100000100001010100011
0000001001100010000101000001000011
0000001010000010000010000100011011
