0000000001010111001001111
0000000001011100111001011
0000000001011101101100011
0000000010011001110010111
0000000010011010101001111
0000000010011010110001111
0000000010011101001101011
0000000010100110110001111
0000000010100111001011101
0000000010101001110011101
0000000010101011100100111
0000000010101100111001011
0000000010110010110011101
0000000010110011100010111
0000000010110011100101011
0000000011010101100100111
0000000100010111001011011
0000000100011100110010111
0000000100101010011110011
0000000100101101110001101
0000000101001011001010111
0000000101001110010011101
0000000101001110110010011
0000000101001111000101101
0000000101010000111110011
0000000101010110001110011
0000000101011000011110011
0000000101011011001000111
0000000101011100110001011
0000000101100010101110011
0000000101100011001101101
0000000101100011010011011
0000000101100011010101011
0000000101101000101110011
0000000101110001011010011
0000000101110010110010011
0000000110001100011011011
0000000110001100101011011
0000000110010010101001111
0000000110010010101110011
0000000110100000111010111
0000000110100011001010111
0000000110100101100010111
0000001000100110001111011
0000001000101001100101111
0000001000101110001101011
0000001000111011100100101
0000001001000111101011001
0000001001001111000110101
0000001001010011010011101
0000001001010110001010111
0000001001011010001110101
0000001001011101000111001
0000001001101000111001101
0000001001101011100001011
0000001001101110000110101
0000001001110001010101101
0000001001110011001001011
0000001001110011010001011
0000001001110100101001101
0000001001110110100000111
0000001010001000111101011
0000001010001001011100111
0000001010001010010111011
0000001010010010011100111
0000001010010010111010011
0000001010010011001110101
0000001010010011100110101
0000001010101100011001011
0000001010110000110110011
0000001010111001100001011
0000001010111100001001101
0000001011000010011011101
0000001011001000011101011
0000001011001110010001011
0000001011100100011001011
0000001011100100100100111
0000001011100100101000111
0000001011100101100100011
0000001011110010100010011
0000001100100000110101111
0000010000010101001110111
0000010000100010100111111
0000010000100011111001101
0000010000101101001100111
0000010000110000101111011
0000010000110010111101001
0000010000110111000110101
0000010000111010010011101
0000010000111101000011011
0000010000111101000110011
0000010001001111000101101
0000010001011100100101011
0000010001011110001100101
0000010001100001111011001
0000010001100010111101001
0000010001100110101001011
0000010001101000111011001
0000010001101100001110101
0000010001110110010010101
0000010001110110101000011
0000010010001101111000101
0000010010001110010110101
0000010010010001100111101
0000010010010100001110111
0000010010011100010101101
0000010010011101100010101
0000010010100000110110111
0000010010100001110011101
0000010010101011001000111
0000010010101101000011011
0000010010110000101110011
0000010010110111001000101
0000010011000010101001111
0000010011001101011000101
0000010011001110000101101
0000010011001111000010101
0000010011010001100101011
0000010011010001110010101
0000010011100111010000101
0000010011101001001000111
0000010011101001100001011
0000010100001000110011111
0000010100001001100111101
0000010100001001111001101
0000010100001100010111011
0000010100001100010111101
0000010100001100100110111
0000010100001111011000011
0000010100010000110110111
0000010100100111010100011
0000010100101000110011011
0000010100110111001000011
0000010101000001011110011
0000010101000001100101111
0000010101000001100110111
0000010101000011001101101
0000010101100010011010011
0000010101110010010100011
0000010110000100010110111
0000010110000100111010011
0000010110001100101010011
0000010110010000101010111
0000010111001001010100011
0000011000010101000111011
0000011000100001111001011
0000011000101001001110011
0000011001000101001011011
0000011001100010101001011
0000011010000110010101011
0000100001000101101100111
0000100001000101111100101
0000100001001100101110101
0000100001001110001100111
0000100001010011001001111
0000100001010100011011011
0000100001010101100011011
0000100001010110100101011
0000100010000100110101111
0000100010001000111101011
0000100010001001011010111
0000100010001011100101101
0000100010001011110000111
0000100010010010101011101
0000100010010100110100111
0000100010011000011110101
0000100010011100001101101
0000100010011100010101101
0000100010011101000101011
0000100010100001011011011
0000100010100001100101111
0000100010101100110000111
0000100010111010001001011
0000100010111010001101001
0000100010111110000101001
0000100011000010011100111
0000100011000110010100111
0000100011001000111010011
0000100011001001010001111
0000100011001010011100011
0000100011001110001100101
0000100011001110010100011
0000100011010010100101011
0000100011010010101101001
0000100011100001101100101
0000100011100110110000101
0000100011101001100101001
0000100011110001101001001
0000100011110100001011001
0000100011110100011001001
0000100011111001100001001
0000100100010100001111011
0000100100010111100011001
0000100100011010001010111
0000100100011100011010101
0000100100110010100011011
0000100101000010110011011
0000100101000011010110101
0000100101000101110010011
0000100101000110001100111
0000100101000110011100011
0000100101000110110010101
0000100101001011000110101
0000100101010100011001011
0000100101100011010100101
0000100101100110100010101
0000100101101011000100101
0000100110010110000110101
0000100110011010001001011
0000100110100011000101011
0000100110100011100100101
0000100110110010101000011
0000100111000110001100101
0000100111001010001100011
0000100111011000101000011
0000100111101000101000101
0000101000100011001101101
0000101000100100101110011
0000101000100101101010011
0000101000101011010010011
0000101001010001110010011
0000101001010010001101011
0000101001010110100100011
0000101001101000100101011
0000101010000110010011011
0000101011010010100100011
0000101011101000100100011
0000101100011010001000111
0000110010010100100010111
0000110011000100101000111
