00000000000000000010111
00000000000000000100111
00000000000000001010011
00000000000000010001011
00000000000000010001101
00000000000000010010011
00000000000000010010101
00000000000000010100011
00000000000000100001011
00000000000000100001101
00000000000000100010101
00000000000000100100011
00000000000000101000011
00000000000001000001011
00000000000001000001101
00000000000001000010011
00000000000001000011001
00000000000001000100101
00000000000001000101001
00000000000001001000011
00000000000001001000101
00000000000001010000011
00000000000010000000111
00000000000010000001011
00000000000010000001101
00000000000010000010011
00000000000010000010101
00000000000010000011001
00000000000010000100101
00000000000010000110001
00000000000010001000011
00000000000010010000011
00000000000010010000101
00000000000010100000011
00000000000100000001011
00000000000100000001101
00000000000100000010011
00000000000100000011001
00000000000100000100011
00000000000100000100101
00000000000100000101001
00000000000100000110001
00000000000100001000101
00000000000100001010001
00000000000100010000011
00000000000100010000101
00000000000100010001001
00000000000100100000011
00000000000100100000101
00000000000101000000011
00000000001000000000111
00000000001000000001101
00000000001000000011001
00000000001000000100011
00000000001000000100101
00000000001000000101001
00000000001000000110001
00000000001000001000011
00000000001000001001001
00000000001000001100001
00000000001000010001001
00000000001000010010001
00000000001000100000101
00000000001000100001001
00000000001001000000101
00000000001010000000011
00000000010000000010011
00000000010000000100011
00000000010000000100101
00000000010000000110001
00000000010000001000011
00000000010000001000101
00000000010000001001001
00000000010000001010001
00000000010000001100001
00000000010000010000101
00000000010000010001001
00000000010000010010001
00000000010000010100001
00000000010000100000011
00000000010000100000101
00000000010000100001001
00000000010001000000011
00000000010001000000101
00000000010010000000101
00000000100000000100011
00000000100000000100101
00000000100000001000011
00000000100000001000101
00000000100000001001001
00000000100000001010001
00000000100000010000011
00000000100000010000101
00000000100000010100001
00000000100000100000011
00000000100000100000101
00000000100000100001001
00000000100000100010001
00000000100001000010001
00000000100010000000101
00000000100010000001001
00000001000000010000011
00000001000000100000011
00000001000000100001001
00000001000000100010001
00000001000001000000101
00000001000001000010001
00000001000001000100001
00000001000010000001001
00000001000010000010001
