000000101101101110111
000000110011101011111
000001000111011011111
000001001101010111111
000001001101111010111
000001001111100111101
000001010110110111011
000001010111011010111
000001011001011110111
000001011011011100111
000001011101110010111
000001011110010111011
000001100011010111111
000001100110101011111
000001101010011101111
000001101101001110111
000010001101110101111
000010001110010111111
000010001110100111111
000010001110110011111
000010001110110101111
000010001111100111011
000010001111110101011
000010010100111011111
000010010111011001111
000010011001110101111
000010011010111001111
000010011100101110111
000010011100111110101
000010011101001111101
000010011101110100111
000010011110011011101
000010011111001110101
000010101001111110011
000010101100101110111
000010101101101100111
000010101110100111011
000010101111100011011
000010101111100101011
000010101111100110011
000010110011011101011
000010110011101011011
000010110111100011101
000010111011001101011
000010111100101100111
000010111100101110011
000010111101101000111
000011001001010111111
000011001010011101111
000011001010100111111
000011001010110110111
000011001110110101011
000011010001011110111
000011010100011011111
000011010100111011011
000100010011110101111
000100010011111010111
000100010101101011111
000100010110101011111
000100100110101111011
000100101011001111101
000100101011110010111
000100101100101111011
000100101110101110011
000100101110101111001
000100101111001110101
000100110001011101111
000100110001101011111
000100110101011010111
000100110101100011111
000100110101101001111
000100110101101010111
000100110101110001111
000100110101110010111
000100110110101110011
000100111000111011011
000100111011011000111
000100111011101001011
000100111110101010011
000101000111011001111
000101001001010111111
000101001100010111111
000101001100110111101
000101001101010111101
000101001110010011111
000101001111000111011
000101001111100100111
000101001111100110101
000101001111110100011
000101011000111101101
000101011010011110011
000101101001110011101
000101110111001010011
000101111010100100111
000101111100101010011
000110010100101011111
000110010100111011011
000110010101001011111
000110010101010011111
000110100101010111011
000110101001001101111
000110111010100100111
