000000001000101111
000000001000111101
000000001001001111
000000001001010111
000000001001101011
000000001010011011
000000001010011101
000000001010100111
000000001011000111
000000001011001011
000000001011010011
000000001100010111
000000001100011011
000000001100101011
000000010001001111
000000010001010111
000000010001011011
000000010010001111
000000010010010111
000000010010100111
000000010010110011
000000010011001011
000000010011010011
000000010100010111
000000010100011011
000000010101010011
000000010101100011
000000010110001011
000000010110010011
000000010110100011
000000011000001111
000000011000011011
000000011000101011
000000011000110011
000000011001001011
000000011010000111
000000100000110111
000000100001010111
000000100001101101
000000100010001111
000000100010100111
000000100100011101
000000100100100111
000000100100110101
000000100101000111
000000100101001101
000000100101100101
000000100110001101
000000100110100101
000000100111000101
000000101000001111
000000101000100111
000000101000101011
000000101000101101
000000101000110011
000000101000110101
000000101001000111
000000101001001101
000000101001010101
000000101010010011
000000101011000011
000000101100000111
000000101101000011
000000110000010111
000000110000101011
000000110001010011
000000110100000111
000001000001001111
000001000001011011
000001000010001111
000001000010011011
000001000010011101
000001000010111001
000001000011001101
000001000011011001
000001000100011011
000001000100101011
000001000100101101
000001000101001011
000001000101101001
000001000110001011
000001000110101001
000001000111001001
000001001000011011
000001001000011101
000001001000101011
000001001000101101
000001001000110011
000001001000110101
000001001000111001
000001001001000111
000001001001010011
000001001001100101
000001001010001011
000001001010001101
000001001010010011
000001001010011001
000001001011000101
000001001100001011
000001001100001101
000001001100010101
000001001100100011
000001001100100101
000001001101000011
000001001110000101
000001010000100111
000001010000110011
000001010001001011
000001010001010011
000001010010001011
000001010010001101
000001010010010011
000001010011000011
000001010100010011
000001010100100011
000001011000010011
000001011000100011
000001011001000011
000010000100010111
000010000100011011
000010000100011101
000010000100110101
000010001000010111
000010001000100111
000010001000101011
000010001000101101
000010001000110011
000010001000111001
000010001001000111
000010001001001011
000010001001001101
000010001001010011
000010001001010101
000010001001011001
000010001001101001
000010001010001011
000010001010010011
000010001010010101
000010001010011001
000010001011000011
000010001011001001
000010001100001101
000010001100010011
000010001100011001
000010001101000011
000010001101001001
000010010000101011
000010010001000111
000010010001001011
000010010001010011
000010010001010101
000010010001011001
000010010010001011
000010010010010101
000010010010100011
000010010100001011
000010010100010011
000010010100010101
000010011000010101
000010011000100011
000010011001000101
000010100010001101
000010100010010011
000010100010010101
000010100100010011
000010100100010101
