000011101111111
000101101111111
000101111011111
000101111101111
000101111110111
000110101111111
000110110111111
000110111011111
000110111101111
000111011011111
001001111011111
001010101111111
001010111011111
001010111101111
001010111110111
001010111111011
001011001111111
001011011101111
001011011110111
001011100111111
001011101101111
001011101110111
001011101111011
001011101111101
001011110111011
001011111010111
001011111100111
001011111101011
001011111110011
001101010111111
001101011011111
001101011110111
001101011111011
001101101011111
001101110101111
001101111010111
001110101101111
001110110101111
