0000000000000100000100000010000001100000010000111
0000000000000100000110000001000001000000100000111
0000000000010000001100000100000001000000100000111
0000000000010000000100000010000011000001000000111
0000000000000000100010000000001000100100010010011
0000000000000000100100000000001001000100100010011
0000000000000000100010010001001000100000000010011
0000000000000000100100010010001001000000000010011
0000000000000100000100000010000001100000011000011
0000000000000110000001000000100000100000011000011
0000000000001000000010000001000001100000101000011
0000000000000000000110000011000001100000001000011
0000000000000010000011000001100000100000001000011
0000000000000000000110000000100001100000110000011
0000000000001100000000000100000001100000110000011
0000000000001100000001000000000001100000110000011
0000000000000010000110000000000001100000110000011
0000000000000100000100000010000001100001010000011
0000000000000100000100000010000001110000010000011
0000000000001000000110000010000000110000010000011
0000000000000100000100000110000001100000010000011
0000000000000100000101000010000001100000010000011
0000000000001000000110000010000010100000010000011
0000000000001000000110000010100000100000010000011
0000000000001000001110000010000000100000010000011
0000000000011000000110000010000000100000010000011
0000000000001000000010000001000001100001100000011
0000000000000100000110000001000001010000100000011
0000000000001000000010000001000011100000100000011
0000000000001000000010000001100001100000100000011
0000000000001000001010000001000001100000100000011
0000000000000100000110000001000011000000100000011
0000000000000100000110000101000001000000100000011
0000000000000100000111000001000001000000100000011
0000000000010000001100000110000001000001000000011
0000000000000010000110000011000001100000000000011
0000000000000100001000000100000010100000010010101
0000000000000100001010000001000010000001000010101
0000000001000000101000010000000010000001000010101
0000000001000000001000000100001010000100000010101
0000000000000100001000000100000010100000010100101
0000000000000101000000100000010000100000010100101
0000000000010000000010000001000010100001000100101
0000000000000000001010000101000010100000000100101
0000000000000001000010100001010000100000000100101
0000000000001000000010000010000001100000110000101
0000000000000000001010000000010010100001010000101
0000000000010100000000010000000010100001010000101
0000000000010100000000100000000010100001010000101
0000000000000001001010000000000010100001010000101
0000000000000100001000000100000010100100010000101
0000000000000100001000000100000010101000010000101
0000000000010000001010000100000000101000010000101
0000000000000100001000010100000010100000010000101
0000000000000100001000100100000010100000010000101
0000000000010000001010000100001000100000010000101
0000000000010000001010000100010000100000010000101
0000000000010000101010000100000000100000010000101
0000000001010000001010000100000000100000010000101
0000000000001000001000000010000011000001100000101
0000000000001000000110000011000000100000100000101
0000000000001000001100000110000010000000100000101
0000000000010000000010000001000010100101000000101
0000000000000100001010000001000010001001000000101
0000000000010000000010000001001010100001000000101
0000000000010000000010000001010010100001000000101
0000000000010000100010000001000010100001000000101
0000000000000100001010000001001010000001000000101
0000000000000100001010010001000010000001000000101
0000000000000100001010100001000010000001000000101
0000000001000000101000010100000010000100000000101
0000000000000001001010000101000010100000000000101
0000000000000100010000001000000100100000010011001
0000000000000100100000010000001000100000010011001
0000000000100000000010000001000100100010000011001
0000000000000000010010001001000100100000000011001
0000000000000000100010010001001000100000000011001
0000000000000001000010000000010000101000010101001
0000000000000001000010100001010000100000000101001
0000000000000100010000001000000100100000011001001
0000000000000100010010000001000100000010001001001
0000000000000000010010000000001100100010010001001
0000000000100100000000010000000100100010010001001
0000000000100100000001000000000100100010010001001
0000000000000100010000001000000100100100010001001
0000000000100000010010001000000000100100010001001
0000000000000100010000001000000100110000010001001
0000000000000100010000011000000100100000010001001
0000000000000100010001001000000100100000010001001
0000000000100000010010001000001000100000010001001
0000000000100000010010001000100000100000010001001
0000000000100010010010001000000000100000010001001
0000000000000100010010000001000100000110000001001
0000000000100000000010000001000100110010000001001
0000000000100000000010000001001100100010000001001
0000000000100000000010000001100100100010000001001
0000000000100010000010000001000100100010000001001
0000000000000100010010000001100100000010000001001
0000000000000100010010010001000100000010000001001
0000000000000100010011000001000100000010000001001
0000000001000100000010010001001000000100000001001
0000000000010000000010000100000010100001010010001
0000000000000000100010000000001100100100010010001
0000000000100000100010000000001000100100010010001
0000000001000000100010010000000100100000010010001
0000000001000000100010010010000000100000010010001
0000000000010000100000000100001010000101000010001
0000000000010000001010000101000000100001000010001
0000000000010000101000010100001000000001000010001
0000000000100000100010010001001000100000000010001
0000000000000010000010000000100000110000011100001
0000000000000010000011000001100000100000001100001
0000000000000001000010000000010010101000010100001
0000000000100000000010001000000100100010011000001
0000000000000010000010000000100001110000011000001
0000000000100000010010001001000000100010001000001
0000000000001000000010000010000001100001110000001
0000000000001000000010000010000001110000110000001
0000000000001000000011000010000001100000110000001
0000000000010000000010000100000010100101010000001
0000000000010000000010000100000010101001010000001
0000000000010000000010100100000010100001010000001
0000000000100000000010001000000100100110010000001
0000000000100000000010001000000100110010010000001
0000000000100000000010011000000100100010010000001
0000000001000000010010010000001000100100010000001
