000000100111011101110101111011011011111
000000101011101101101111010111011101111
000000110111100110101111010111111001111
000001000111011011101111010110110111111
000001010111011011001110011110110111111
000001011011011101110011111010101101111
000001011011111111100011111011100101011
000001011111001101110010111010111101111
000001101011011110011011011111010111011
000010101001011111011110011110110111011
000011010101111110110011011111011000111
000011010101111110110011110111001001111
000011101011001111011001000111110111111
000011110111001010101000110110111111111
000100010101110001111011011011110111111
000100100111110101111110011010110101111
000100110011110101111110011010101101111
000101001111011101101100111111100101101
000101010100111110110110111101101110011
000101100111011100110100111111101001111
000101100111011110110101011111101000111
000101101111001110110001110100111111011
000101101111001111011111110010101010011
000101101111001111110101110100100111011
000111001111111011011010101001001110111
000111011011011001010010011101011111111
000111011100100111010110110101011101111
