00000000000100011100100100100101111
00000000001000010101001110100100111
00000000001011000101100010110001011
00000000010100010010110000101110011
00000000011010101010110010000000111
00000000100000110010011001001010111
00000000100011010001101000110100011
00000000101000010011001001101000111
00000000101001001100000101100100111
00000001000101100010110001011000101
00000001001010001000010010101001111
00000001010010001000011000101011011
00000001100111000001000001010010111
00000010000001000111100000110001111
00000010000001010101101000010101011
00000010000001011001100100010110011
00000010000011000000100011110001111
00000010000011000001100011010001111
00000010000011000010100011110001011
00000010000011000011100011010001011
00000010000011000100100011110000111
00000010000011000101100011010000111
00000010000011000110100011110000011
00000010000011000111100000110001101
00000010000011000111100011010000011
00000010000011010100101000010101011
00000010000011010100101000110101001
00000010000011011000100100010110011
00000010000011011000100100110110001
00000010000100001110010101010010011
00000010000101000000110101011010101
00000010000101000010110100011010101
00000010000101000101100000110001111
00000010000101000101100001110001011
00000010000101001000110101011000101
00000010000101001010110100011000101
00000010000101100000110101010010101
00000010000101100010110100010010101
00000010000101100100100010011001101
00000010000101100100100011011001001
00000010000101101000110101010000101
00000010000101101010100001011010001
00000010000101101010110100010000101
00000010000110000011010001110110001
00000010000111000010100010110001011
00000010000111000011100010010001011
00000010000111000101100000110001101
00000010000111000101100001110001001
00000010000111000110100010110000011
00000010000111000111100010010000011
00000010001001000000110011011001101
00000010001001000010110011011001001
00000010001001000011100000110001111
00000010001001000011100010110000111
00000010001001000100110001011001101
00000010001001000110110001011001001
00000010001001010001101000010101011
00000010001001010001101010010100011
00000010001001100000110011010001101
00000010001001100010110011010001001
00000010001001100100110001010001101
00000010001001100110100010011000101
00000010001001100110110001010001001
00000010001010000101100010110001011
00000010001011000011100000110001101
00000010001011000011100010110000101
00000010001011000100100001110000111
00000010001011000101000010110001011
00000010001011000101100001010000111
00000010001011000101100010100001011
00000010001011000110100001110000011
00000010001011000111100001010000011
00000010001011010000101000010101011
00000010001011010000101000110101001
00000010001011010000101010010100011
00000010001100000110100011010001101
00000010001101000001100000110001111
00000010001101000001100001110001011
00000010001101000001100010110000111
00000010001101000001100011110000011
00000010001101000010110010011001001
00000010001101000110000011010001101
00000010001101000110100011000001101
00000010001101000110110000011001001
00000010001101100010110010010001001
00000010001101100100100010011000101
00000010001101100110110000010001001
00000010001111000001100000110001101
00000010001111000001100001110001001
00000010001111000001100010110000101
00000010001111000110100000110000011
00000010010001001000101000110110011
00000010010001010000101100110010011
00000010010001011000101000110010011
00000010010001011001100100010100011
00000010010001100010100001011010101
00000010010001100010100101011000101
00000010010011011000100100010100011
00000010010101001000110001011000101
00000010010101001010110000011000101
00000010010101101000110001010000101
00000010010101101010110000010000101
00000010100001000100101010110100011
00000010100001001001100100010110011
00000010100001001001101100010010011
00000010100001010000100010110101011
00000010100001010100100010110100011
00000010100001010101101000010001011
00000010100010010001101000110100011
00000010100011001000100100010110011
00000010100011001000101100010010011
00000010100011010001001000110100011
00000010100011010001101000100100011
00000010100011010100101000010001011
00000010100101110100011000001000011
00000010100110101000011001000010011
00000010101001000100101000110100011
00000010101001010001101000010001011
00000010101001010001101010010000011
00000010101001010100100000110100011
00000010101011010000101000010001011
00000010101011010000101010010000011
00000010110001001001100100010100011
00000010110001001001101100010000011
00000010110001010000100100110010011
00000010110001011000100000110010011
00000010110011001000100100010100011
00000010110011001000101100010000011
00000100000100000100001100010111111
00000100001001000101100010110001011
00000100001010000101001000110101011
00000100001010001000110111001000101
00000100001010001001100100100011011
00000100001010001001100110100010011
00000100001010010001001010110001011
00000100001010010101001000110001011
00000100001010010101100010100100011
00000100001011000100100010110001011
00000100001011000101100010010001011
00000100001011000101100010110001001
00000100001011001001000100100011011
00000100001011001001000110100010011
00000100001011010101000010100100011
00000100010010000101000110110010011
00000100010010001001000010110011011
00000100010010001101000010110010011
00000100010010001101100100100001011
00000100010011001101000100100001011
00000100011001000100100100000111101
00000100011010000101000100110010011
00000100011010001001100100100001011
00000100011011001001000100100001011
00000100011011100000100100100010101
00000100100001010001101000110100011
00000100100010000101100010100101011
00000100100010000101101010100001011
00000100100010100001100000111100011
00000100100010100001101000111000011
00000100100011000101000010100101011
00000100100011000101001010100001011
00000100100011010000101000110100011
00000100100011010001010000111000011
00000100100011010001101000010100011
00000100100011010001110000101000011
00000100100011110001010000110000011
00000100101010000101100010100100011
00000100101010010001000010110001011
00000100101011000101000010100100011
00000100101111001000100001100000101
00000101000010010001100000111100011
00000101000010010001110000110100011
00000101000011100001001000110100011
00000101000011100001101000100100011
00000101000011110001001000110000011
00000110000101000011100010010001011
00000110000101000100100001110001011
00000110000111000100100001010001011
00000110001001000010100010110000111
00000110001001000101000010110001011
00000110001001000101100001010000111
00000110001001000101100010100001011
00000110001010000100100010110001011
00000110001010000101001000100101011
00000110001010000101100010010001011
00000110001010010001001010100001011
00000110001010010101001000100001011
00000110001011000010100010010000111
00000110001011000100100010100001011
00000110001011000101000010010001011
00000110010001001000101000010110011
00000110010001010000101100010010011
00000110010001011000101000010010011
00000110010010001001000010100011011
00000110100001010000100010010101011
