0000000110111110111011110100111
0000000111000111011011011111111
0000001010110110111101011101111
0000001011101111011110010111011
0000001100111101101111010111011
0000001101011101101110111001111
0000010001110110110111101011111
0000010011011111110101110011101
0000010011101111111001011011011
0000010110010110101110011111111
0000010110101110101101101110111
0000010110111111001011101110011
0000010111001011100101111111101
0000010111001110111010110110111
0000010111001111100111001011111
0000010111011010110111111000111
0000010111011010111001101101111
0000010111100101110110111100111
0000011000101111101101011110111
0000011001110011010111101011111
0000011010011101110001111111011
0000011010101110011110110110111
0000011010110110110111011101011
0000011011001010111001111110111
0000011011010101110110101110111
0000011011100011010111110101111
0000011011100011101001111111011
0000011011111011010111000101111
0000100010111100010111111101111
0000100011011111101011101011011
0000100011101010111011011111101
0000100011110100111110111011101
0000100011111101011101101101011
0000100101011110111110001011111
0000100101101111000110111011111
0000100101111110011101010110111
0000100110011111111100101010111
0000100110100111010011101111111
0000100110111010110101101011111
0000100111001011101001111111101
0000100111011101011011111001101
0000100111100110111010101101111
0000100111100111100110111011101
0000100111101111001101100101111
0000101001101111100011110111101
0000101001111101111100100111011
0000101010011101100101111101111
0000101010011101111001111011011
0000101010110110110011100111111
0000101010111110110110111100011
0000101011001001100111110111111
0000101011110011011100111101101
0000101100011011111101101010111
0000101100100111111010011110111
0000101100101011100111011111101
0000101100101110101100111111101
0000101100111100011011110110111
0000101101011101111001100110111
0000101101111011100110111010011
0000101110001011011111101110011
0000101110010111011100111101011
0000101110011101101100101101111
0000101110101101000110011111111
0000101110101111001110110110011
0000101111011011001111001010111
0000101111011110110100011100111
0000101111111101010011001001111
0000110001101010101101101111111
0000110010011011110110101011111
0000110010101111011001011101111
0000110011010100101111101110111
0000110011111101011011001010111
0000110100011011101011011110111
0000110100110111011010101111011
0000110101010111111101100011011
0000110101011111011110001011011
0000110110001011011110111010111
0000110110010101101010111110111
0000110110011110101001011110111
0000110110101011101111011000111
0000110110101011110001110111011
0000110110111010100101100111111
0000111011010100010110011111111
0000111011101111011000101001111
0001000101111000101110111101111
0001000101111100011011110101111
0001000101111101101110010101111
0001001001011100011011111011111
0001001001011101110011101011111
0001001001011111110101110011101
0001001001111101010110111100111
0001001001111111010011101011011
0001001010111101111011100010111
0001001010111111010011111010011
0001001011001111010110111111001
0001001011100101011001111011111
0001001011100101110010111110111
0001001011100110111100101111101
0001001011111011000111110101011
0001001100011011110001111011111
0001001100011111111001011011011
0001001100111101111100010101111
0001001101001011110100111110111
0001001101001101011110101111011
0001001101001101111101011010111
0001001101001111101101011110011
0001001101010011100111101111101
0001001101011010011111101110101
0001001101011110011111000101111
0001001101100011010111101110111
0001001101110011110101011010111
0001001101110101111010101110011
0001001101111000101011110011111
0001001101111011101011110001101
0001001110011010011010111101111
0001001110011111010101011011011
0001001110011111010110011101101
0001001110100110101011011110111
0001001110101110010110100111111
0001001110110110111100011101011
0001001110111011111000101101101
0001001111001101010101111011011
0001001111001101010110110111101
0001001111001111101000101111011
0001001111100011101111011010011
0001001111101110101111000110101
0001001111110011101101101100101
0001010001010011111101010111111
0001010010101100111010011111111
0001010010110001110110011111111
0001010011010111111000111110011
0001010011100101011100111111101
0001010011100110010111110011111
0001010011101101000111111011101
0001010011101111110011011010011
0001010011110011011011100111101
0001010011110101011011101100111
0001010011111011110110001011101
0001010011111101001111110100011
0001010100111101100011111101101
0001010100111111001011011110011
0001010100111111010110011110101
0001010101001001101111011011111
0001010101001111101101101110011
0001010101101100011111101101101
0001010110001101111110110100111
0001010110001111110100110011111
0001010110010100111110111011011
0001010110111001101111001101101
0001010111011110110101001001111
0001010111101111100011001001111
0001011000111011010011111101101
0001011000111101101101001110111
0001011001010100110011101111111
0001011001110100101111110100111
0001011001110100111110100111011
0001011010111010011011001110111
0001011100100101111101111000111
0001011100100101111111010110011
0001011100111101010011111010011
0001011101001110011101011011011
0001011110111101100100101010111
0001011111010010111001101100111
0001011111010010111011011000111
0001100101010011111010011111011
0001100101011101111110010010111
0001100101011110100111011011011
0001100111111101101010010010111
0001101010011101001001111011111
0001101100111100111101010010111
0001101101010110010011100111111
0001101101100100111101101010111
0001101101111011010101001001111
0001110010010101111101001101111
0001110011010010101110110011111
0001110100110011001010011111111
0001110101101001100101010111111
0001110110101001001001101111111
0001110111001001010101101101111
0001110111011101001010010011111
