0000000000100000000011
0000000000000001000101
0000000000000100000101
0000000000010000000101
0000000000100000000101
0000000000100000001001
0000000000010000010001
0000000000100000010001
0000000001000000010001
0000000000100000100001
