0000000000010111
0000000000100111
0000000001010011
0000000010001011
0000000010001101
0000000010010011
0000000010100011
0000000100000111
0000000100001101
0000000100010101
0000000100100011
0000000100100101
0000000101000011
0000000101000101
0000001000001011
0000001000010011
0000001000010101
0000001000011001
0000001000100101
0000001000101001
0000001010000011
0000010000010101
0000010000100011
0000010000100101
0000010000110001
0000010001000101
0000010001001001
0000010010000101
