0000000000000000000100000100000100000100000111111
0000000010000000100000001000000010000000100011111
0000000000010000000000010000000000010010101010111
0000000000000000000000110000100010001000100010111
0000000000000000000000111000000000100100100100111
0000000010100000001000100000100000100010000000111
0000000000000001100000000000000110000001010101011
0000000001000000000110100000000100001000001001011
0000000000100101000001000010001000000100000001011
0000000000100011000010000000010000000100001010011
0000000000010000001001010000000000011000010010011
0000000000000000000000010000110001010010010100011
0000000010100000001001000000100010000010000100011
0000000010001000010000000101001000000100000100011
0000000010000001000110000000100000000101001000011
0000000000110000001000001000010000100100100000011
0000000010000000110000001001000010000100100000011
0000000010010000000101001000100000100001000000011
0000000000000001010010010010010110000000000000011
0000000010000000010011000000100000000100000011101
0000000000000010000100001000000000001001011001101
0000000000101100000100000000011000000001000001101
0000000001000010000001100000010001100000000010101
0000000000001000100000001001000110000000101000101
0000000000000010100000000000001101100010001000101
0000000000000010001000001000011100001000001000101
0000000000100000000001000010010100001000110000101
0000000010000000010000000010001100001001010000101
0000000010000001100100000001000110000010000000101
0000000000100010100100000000100101000100000000101
0000000000100000000111000000010000000000100111001
0000000001000000001000101000001000011000001001001
0000000010000000110100100010000000010000001001001
0000000000100000001100100110000000100000001001001
0000000001000000100010101000100010010000000001001
0000000010000000010000000010000000010000111110001
0000000010000100001000010000100010001000100010001
0000000010000010001001000010010001000001000010001
0000000000100000000001000000000010000011111100001
0000000000001000010000000000101100100100100100001
0000000000000000100001000000101010101010000100001
0000000000001000010000000001011101010000000100001
