000101111111101111011111111111111011111
000110111111111011111011111111110111111
001011110111011101111101111111111111111
001011111110111110111111111111011110111
001011111111111101111110111111011101111
001101011111101111111011111110111111111
001101111111111111011111011110101111111
001110101111110110111111101111111111111
001110110111111110101111111111111101111
001111101011011111111111101110111111111
001111111101101010111011111111111111111
001111111101101111010111011111111111111
