000000000000001000100001100011000100001100011
000000000000001000110000000011000110001100011
000000000000001000110001000011000100001100011
000000000000001000110001000011000110001000011
000000000000001000110001100011000100000100011
000000000000001001000010100101001000010100101
000000000000001001010000000101001010010100101
000000000000001001010010000101001000010100101
000000000000001001010010000101001010010000101
000000000000001001010010100101001000000100101
000000000000010000010001100011000010001100011
000000000000010000110000000011000110001100011
000000000000010000110000100011000010001100011
000000000000010000110000100011000110000100011
000000000000010000110001100011000010001000011
000000000000011000000001100001000110001100011
000000000000011000000001100010000110001100011
000000000000011000010001100001000110000100011
000000000000011000010001100010000010001100011
000000000000011000010001100010000110000100011
000000000000011000100001100001000100001100011
000000000000100000010010100101000010010100101
000000000000100001010000000101001010010100101
000000000000100001010000100101000010010100101
000000000000100001010000100101001010000100101
000000000000100001010010100101000010010000101
000000000000101000000010100001001010010100101
000000000000101000000010100100001010010100101
000000000000101000010010100001001010000100101
000000000000101000010010100100000010010100101
000000000000101000010010100100001010000100101
000000000000101001000010100001001000010100101
000000000001000000010100101001000010100101001
000000000001000010010000001001010010100101001
000000000001000010010000101001000010100101001
000000000001000010010000101001010010000101001
000000000001000010010100101001000010100001001
000000000001001000000100100001010010100101001
000000000001001000000100101000010010100101001
000000000001001000010100100001010010000101001
000000000001001000010100101000000010100101001
000000000001001000010100101000010010000101001
000000000001001010000100100001010000100101001
000000000010000000011000110001000011000110001
000000000010000100010000010001100011000110001
000000000010000100010000110001000011000110001
000000000010000100010000110001100010000110001
000000000010000100011000110001000011000010001
000000000010001000001000100001100011000110001
000000000010001000001000110000100011000110001
000000000010001000011000100001100010000110001
000000000010001000011000110000000011000110001
000000000010001000011000110000100010000110001
000000000010001100001000100001100001000110001
000000000100000000100001100011000100001100011
000000000100000000110001100000000110001100011
000000000100000000110001100001000010001100011
000000000100000000110001100010000100001100011
000000000100000000110001100011000000001100011
000000000100000001000010100101001000010100101
000000000100000001010010100000001010010100101
000000000100000001010010100001000010010100101
000000000100000001010010100100001000010100101
000000000100000001010010100101000000010100101
000000000100000010000100101001010000100101001
000000000100000010010100100000010010100101001
000000000100000010010100100001000010100101001
000000000100000010010100101000010000100101001
000000000100000010010100101001000000100101001
000000000100000100001000110001100001000110001
000000000100000100011000100000100011000110001
000000000100000100011000100001000011000110001
000000000100000100011000110000100001000110001
000000000100000100011000110001000001000110001
000000000100001000010000000011000110001100011
000000000100001000010000000101001010010100101
000000000100001000010000001001010010100101001
000000000100001000010000010001100011000110001
000000000100001000010000100010000110001100011
000000000100001000010000100100001010010100101
000000000100001000010000101000010010100101001
000000000100001000010000110000100011000110001
000000000100001000010001000011000110001100001
000000000100001000010001100010000110001100001
000000000100001000010010000101001010010100001
000000000100001000010010100100001010010100001
000000000100001000010100001001010010100100001
000000000100001000010100101000010010100100001
000000000100001000011000010001100011000100001
000000000100001000011000110000100011000100001
000000000100001000100000100011000100001100011
000000000100001000100001000011000100001100011
000000000100001000100001000011000110000100011
000000000100001000100001000011000110001000011
000000000100001000100001100001000100001100011
000000000100001000100001100001000110001000011
000000000100001000100001100010000010001100011
000000000100001000100001100010000100001100011
000000000100001000100001100011000000001100011
000000000100001000100001100011000100000100011
000000000100001000100001100011000100001000011
000000000100001000110000100010000100001100011
000000000100001000110001000001000100001100011
000000000100001000110001000011000010001000011
000000000100001000110001100001000010001000011
000000000100001001000000100101001000010100101
000000000100001001000010000101001000010100101
000000000100001001000010000101001010000100101
000000000100001001000010000101001010010000101
000000000100001001000010100001001000010100101
000000000100001001000010100001001010010000101
000000000100001001000010100100000010010100101
000000000100001001000010100100001000010100101
000000000100001001000010100101000000010100101
000000000100001001000010100101001000000100101
000000000100001001000010100101001000010000101
000000000100001001010000100100001000010100101
000000000100001001010010000001001000010100101
000000000100001001010010000101000010010000101
000000000100001001010010100001000010010000101
000000000100001010000000101001010000100101001
000000000100001010000100001001010000100101001
000000000100001010000100001001010010000101001
000000000100001010000100001001010010100001001
000000000100001010000100100001010000100101001
000000000100001010000100100001010010100001001
000000000100001010000100101000000010100101001
000000000100001010000100101000010000100101001
000000000100001010000100101001000000100101001
000000000100001010000100101001010000000101001
000000000100001010000100101001010000100001001
000000000100001010010000101000010000100101001
000000000100001010010100000001010000100101001
000000000100001010010100001001000010100001001
000000000100001010010100100001000010100001001
000000000100001100000000110001100001000110001
000000000100001100001000010001100001000110001
000000000100001100001000010001100010000110001
000000000100001100001000010001100011000010001
000000000100001100001000100001100001000110001
000000000100001100001000100001100011000010001
000000000100001100001000110000000011000110001
000000000100001100001000110000100001000110001
000000000100001100001000110001000001000110001
000000000100001100001000110001100000000110001
000000000100001100001000110001100001000010001
000000000100001100010000110000100001000110001
000000000100001100011000000001100001000110001
000000000100001100011000010001000011000010001
000000000100001100011000100001000011000010001
000000000100010000010000000011000110001100011
000000000100010000010000100011000110001000011
000000000100010000010001000011000010001100011
000000000100010000010001100011000010001000011
000000000100010000010001100011000100001000011
000000000100010000100001000011000010001100011
000000000100010000100001100000000110001100011
000000000100010000100001100001000100001100011
000000000100010000100001100001000110000100011
000000000100010000100001100010000110001000011
000000000100010000100001100011000110000000011
000000000100010000110000000011000110000100011
000000000100010000110000100001000010001100011
000000000100010000110000100011000110000000011
000000000100010000110001000010000110000100011
000000000100010000110001000010000110001000011
000000000100010000110001000011000010000100011
000000000100010000110001000011000100001000011
000000000100010000110001100011000010000000011
000000000100011000000001100001000100001100011
000000000100011000010000100010000110001000011
000000000100011000010001000010000010001100011
000000000100011000010001000010000110000100011
000000000100011000010001000010000110001000011
000000000100011000010001100001000100001000011
000000000100011000010001100010000010001000011
000000000100011000100001000001000100001100011
000000000100011000100001100000000100001100011
000000000100011000100001100001000100000100011
000000000100011000100001100001000100001000011
000000000100011000110000000010000110000100011
000000000100011000110000100001000010001000011
000000000100011000110000100010000100001000011
000000000100011000110000100010000110000000011
000000000100011000110001000001000100001000011
000000000100011000110001100010000010000000011
000000000100100000010000000101001010010100101
000000000100100000010000100101001010010000101
000000000100100000010010000101000010010100101
000000000100100000010010100101000010010000101
000000000100100000010010100101001000010000101
000000000100100001000010000101000010010100101
000000000100100001000010100000001010010100101
000000000100100001000010100001001000010100101
000000000100100001000010100001001010000100101
000000000100100001000010100100001010010000101
000000000100100001000010100101001010000000101
000000000100100001010000000101001010000100101
000000000100100001010000100001000010010100101
000000000100100001010000100101001010000000101
000000000100100001010010000100001010000100101
000000000100100001010010000100001010010000101
000000000100100001010010000101000010000100101
000000000100100001010010000101001000010000101
000000000100100001010010100101000010000000101
000000000100101000000010100001001000010100101
000000000100101000010000100100001010010000101
000000000100101000010010000100000010010100101
000000000100101000010010000100001010000100101
000000000100101000010010000100001010010000101
000000000100101000010010100001001000010000101
000000000100101000010010100100000010010000101
000000000100101001000010000001001000010100101
000000000100101001000010100000001000010100101
000000000100101001000010100001001000000100101
000000000100101001000010100001001000010000101
000000000100101001010000000100001010000100101
000000000100101001010000100001000010010000101
000000000100101001010000100100001000010000101
000000000100101001010000100100001010000000101
000000000100101001010010000001001000010000101
000000000100101001010010100100000010000000101
000000001000001000010000100011000100001100011
000000001000001000010001100000000110001100011
000000001000001000010001100001000110000100011
000000001000001000010001100010000010001100011
000000001000001000010001100010000110001000011
000000001000001000010001100011000110000000011
000000001000001000100000100011000100001100011
000000001000001000100000100011000110001100001
000000001000001000100001000011000110000100011
000000001000001000100001100010000110001100001
000000001000001000100001100011000010000100011
000000001000001000100001100011000100000100011
000000001000001000110000000011000110001000011
000000001000001000110000100001000110000100011
000000001000001000110000100001000110001000011
000000001000001000110000100011000010000100011
000000001000001000110000100011000010001100001
000000001000001000110000100011000100001000011
000000001000001000110001000010000100001100011
000000001000001000110001000011000110000000011
000000001000001000110001000011000110000100001
000000001000001000110001100000000110001100001
000000001000001000110001100010000010001100001
000000001000010000010000100011000010001100011
000000001000010000010000100011000110000100011
000000001000010000010000100011000110001000011
000000001000010000010001000011000010001100011
000000001000010000010001000011000110001100001
000000001000010000010001100001000010001100011
000000001000010000010001100001000100001100011
000000001000010000010001100001000110001100001
000000001000010000010001100010000010001100011
000000001000010000010001100010000110000100011
000000001000010000010001100011000000001100011
000000001000010000010001100011000010000100011
000000001000010000010001100011000010001000011
000000001000010000010001100011000010001100001
000000001000010000100001000001000110001100011
000000001000010000110000100010000010001100011
000000001000010000110000100011000100000100011
000000001000010000110001000001000010001100011
000000001000010000110001100010000100000100011
000000001000011000000001100010000010001100011
000000001000011000010000100010000010001100011
000000001000011000010001100010000010000100011
000000001000011000010001100010000010001000011
000000001000011000010001100010000010001100001
000000001000011000100000100001000100001100011
000000001000011000100000100001000110000100011
000000001000011000100000100001000110001000011
000000001000011000100001000001000110000100011
000000001000011000100001100001000100000100011
000000001000011000100001100010000010000100011
000000001000011000110000100010000010000100011
000000001000011000110001000001000010000100011
000000001000011000110001000001000110000000011
000000001000011000110001000010000100000100011
000000001100001000010001000010000010001100011
000000001100001000010001100010000010001000011
000000001100001000100000100001000100001100011
000000001100001000100000100010000100001100011
000000001100001000100001000010000010001100011
000000001100001000100001000011000100000100011
000000001100001000100001100010000100000100011
000000001100010000010000100001000100001100011
000000001100010000010001000001000010001100011
000000001100010000010001000010000010001100011
000000001100010000010001000011000010000100011
000000001100010000100000100001000100001100011
000000010000001000010000100101001000010100101
000000010000001000010010100000001010010100101
000000010000001000010010100001001010000100101
000000010000001000010010100100000010010100101
000000010000001000010010100100001010010000101
000000010000001000010010100101001010000000101
000000010000001001000000100101001000010100101
000000010000001001000000100101001010010100001
000000010000001001000010000101001010000100101
000000010000001001000010100100001010010100001
000000010000001001000010100101000010000100101
000000010000001001000010100101001000000100101
000000010000001001010000000101001010010000101
000000010000001001010000100001001010000100101
000000010000001001010000100001001010010000101
000000010000001001010000100101000010000100101
000000010000001001010000100101000010010100001
000000010000001001010000100101001000010000101
000000010000001001010010000100001000010100101
000000010000001001010010000101001010000000101
000000010000001001010010000101001010000100001
000000010000001001010010100000001010010100001
000000010000001001010010100100000010010100001
000000010000100000010000100101000010010100101
000000010000100000010000100101001010000100101
000000010000100000010000100101001010010000101
000000010000100000010010000101000010010100101
000000010000100000010010000101001010010100001
000000010000100000010010100001000010010100101
000000010000100000010010100001001000010100101
000000010000100000010010100001001010010100001
000000010000100000010010100100000010010100101
000000010000100000010010100100001010000100101
000000010000100000010010100101000000010100101
000000010000100000010010100101000010000100101
000000010000100000010010100101000010010000101
000000010000100000010010100101000010010100001
000000010000100001000010000001001010010100101
000000010000100001010000100100000010010100101
000000010000100001010000100101001000000100101
000000010000100001010010000001000010010100101
000000010000100001010010100100001000000100101
000000010000101000000010100100000010010100101
000000010000101000010000100100000010010100101
000000010000101000010010100100000010000100101
000000010000101000010010100100000010010000101
000000010000101000010010100100000010010100001
000000010000101001000000100001001000010100101
000000010000101001000000100001001010000100101
000000010000101001000000100001001010010000101
000000010000101001000010000001001010000100101
000000010000101001000010100001001000000100101
000000010000101001000010100100000010000100101
000000010000101001010000100100000010000100101
000000010000101001010010000001000010000100101
000000010000101001010010000001001010000000101
000000010000101001010010000100001000000100101
000000010100001000010010000100000010010100101
000000010100001000010010100100000010010000101
000000010100001001000000100001001000010100101
000000010100001001000000100100001000010100101
000000010100001001000010000100000010010100101
000000010100001001000010000101001000000100101
000000010100001001000010100100001000000100101
000000010100100000010000100001001000010100101
000000010100100000010010000001000010010100101
000000010100100000010010000100000010010100101
000000010100100000010010000101000010000100101
000000010100100001000000100001001000010100101
