00000000001000000010010000000001100000001111
00000000001000000000110000000010100000001111
00000000001000000000110000000100100000001111
00000000001001000000010000000001100100000111
00000000001000000000110000000110100000000111
00000000001000000010110000000010100000000111
00000000001000000010110000000100100000000111
00000000001000000000110001000000100010001011
00000000001000000010010000000011100000001011
00000000000000000010110000000101100000001011
00000000010000000010010000000101100000001011
00000000001000000010100000000101100000001011
00000000001000000011010000000001100000001011
00000000001000000000110000000110100000001011
00000000001000000001110000000010100000001011
00000000011000000010010000000010100000001011
00000000001000000001110000000100100000001011
00000000010000000010110000000100100000001011
00000000011000000010100000000100100000001011
00000000001000100000110001000000100000001011
00000000001000000010110000000101000000001011
00000000011000000010010000000101000000001011
00000000001000000100010000100000100001010011
00000000001000000100010000000001100100010011
00000000001000000000110000001000100100010011
00000000001000000100010010000000100100010011
00000000010001000000100000001001000100010011
00000000000000000100110000001001100000010011
00000000010000000100010000001001100000010011
00000000001000000100100000001001100000010011
00000000001000000100010010000001100000010011
00000000010000000100101000000001100000010011
00000000001001000100010000000001100000010011
00000000001000000000110010001000100000010011
00000000010000000100110000001000100000010011
00000000001001000000110000001000100000010011
00000000011000000100100000001000100000010011
00000000001000010100010000100000100000010011
00000000001001000100010010000000100000010011
00000000011000000100010010000000100000010011
00000000001000000100110000001001000000010011
00000000011000000100010000001001000000010011
00000000010001000000110010000001000000010011
00000000011000000100101000000001000000010011
00000000010000010000100000010001000001100011
00000000010000001000100000100001000001100011
00000000000000001000110000010001100000100011
00000000010000001000010000010001100000100011
00000000001000001000100000010001100000100011
00000000010000001000110000010000100000100011
00000000011000001000100000010000100000100011
00000000001000001000110000010001000000100011
00000000010010000000110000010001000000100011
00000000011000001000010000010001000000100011
00000000010000011000100000100001000000100011
00000000001000010000010000000001100011000011
00000000001000100000010000100000100011000011
00000000001000010000010001000000100011000011
00000000010001000000100000100001000101000011
00000000010000010000100000010001100001000011
00000000001000010000010001000001100001000011
00000000001000110000010000000001100001000011
00000000001000110000010001000000100001000011
00000000011000010000010001000000100001000011
00000000010000011000100000010001000001000011
00000000000000100000110001000001100010000011
00000000010000100000010001000001100010000011
00000000001000100000100001000001100010000011
00000000001000000000110001000100100010000011
00000000001000110000010000100000100010000011
00000000001000000010110001000000100010000011
00000000010000100000110001000000100010000011
00000000001000100000110001000001000010000011
00000000001001000000010000000011100100000011
00000000010001000000100000001001100100000011
00000000000001000000110010000001100100000011
00000000010001000000010010000001100100000011
00000000001001000000100010000001100100000011
00000000001001000001010000000001100100000011
00000000001000000100110000001000100100000011
00000000010001000000110010000000100100000011
00000000010001000100100000001001000100000011
00000000010001010000100000100001000100000011
00000000010000000100110010000001000100000011
00000000001001000000110010000001000100000011
00000000000010000000110100000001101000000011
00000000010010000000010100000001101000000011
00000000001010000000100100000001101000000011
00000000010010000000101000000001101000000011
00000000010010000000110100000000101000000011
00000000010000001000110000010001001000000011
00000000001010000000110100000001001000000011
00000000010100000000110100000001001000000011
00000000010100000000111000000001001000000011
00000000010010000000110100000001010000000011
00000000010010000000111000000001010000000011
00000000001000000001110000000110100000000011
00000000001000000010110000000110100000000011
00000000001000000011110000000010100000000011
00000000001000100000110001000100100000000011
00000000001000000011110000000100100000000011
00000000001000000100110010001000100000000011
00000000001001000100110000001000100000000011
00000000001000100010110001000000100000000011
00000000001000000001010000000100100001001101
00000000001000000010110000000001100000001101
00000000001000000011000000000110100000001101
00000000001000000001010000100100100000001101
00000000001000010001010000000100100000001101
00000000001000000011010000000110000000001101
00000000001000001000010000000010100000110101
00000000001000010000010000000010100001010101
00000000001000000001010000001000100001010101
00000000001000000001010000100000100001010101
00000000001000000001010000101000100000010101
00000000001000010001010000001000100000010101
00000000001000010001010000100000100000010101
00000000001001000000010000000010100100100101
00000000001001000000010000010000100100100101
00000000001000000001010010000000100100100101
00000000100000001001000010000010000100100101
00000000001000001000010000001010100000100101
00000000000000001001010000010010100000100101
00000000100000001000010000010010100000100101
00000000001000001001000000010010100000100101
00000000100000001001000010000010100000100101
00000000001000001100010000000010100000100101
00000000101000001000010000001000100000100101
00000000100000001001010000010000100000100101
00000000101000001001000000010000100000100101
00000000001001000001010010000000100000100101
00000000001000001001010000010010000000100101
00000000100001000001010000010010000000100101
00000000101000001000010000010010000000100101
00000000100001001001000010000010000000100101
00000000101000001001000010000010000000100101
00000000001000010000010000001010100001000101
00000000000000010001010000100010100001000101
00000000100000010000010000100010100001000101
00000000001000010001000000100010100001000101
00000000001000010100010000000010100001000101
00000000001000000011010000000100100001000101
00000000001000000001010000101000100001000101
00000000001000000101010000001000100001000101
00000000101000010000010000001000100001000101
00000000001000000101010000100000100001000101
00000000100000010001010000100000100001000101
00000000101000010001000000100000100001000101
00000000001000010001010000100010000001000101
00000000101000010000010000100010000001000101
00000000000000100001010001000010100010000101
00000000100000100000010001000010100010000101
00000000001000100001000001000010100010000101
00000000100000100001000100000010100010000101
00000000100000100001010001000000100010000101
00000000001000100001010001000010000010000101
00000000100010000001010001000010000010000101
00000000100010000001010100000010000010000101
00000000100100000001011000000010000010000101
00000000001001000000110000000001100100000101
00000000001001000000010000010010100100000101
00000000000001000001010010000010100100000101
00000000100001000000010010000010100100000101
00000000001001000001000010000010100100000101
00000000100001000001000100000010100100000101
00000000001001001000010000000010100100000101
00000000001000000001010010010000100100000101
00000000001001001000010000010000100100000101
00000000001000001001010010000000100100000101
00000000100001000001010010000000100100000101
00000000100000001001010000010010000100000101
00000000001001000001010010000010000100000101
00000000100000100001010001000010001000000101
00000000100000100001010100000010001000000101
00000000000100000001011000000010110000000101
00000000100000100001011000000010010000000101
00000000001000000011010000100100100000000101
00000000001000010011010000000100100000000101
00000000001000000101010000101000100000000101
00000000001000010001010000101000100000000101
00000000001000010101010000001000100000000101
00000000001001000001010010010000100000000101
00000000001000010101010000100000100000000101
00000000001001001001010010000000100000000101
00000000001000000110000000001100100000011001
00000000001000000110010000001100000000011001
00000000001000001010000000010100100000101001
00000000001000001010010000010100000000101001
00000000001000000010010000100000101001001001
00000000001000000010010100000000101001001001
00000000001000000010010100100000100001001001
00000000001000100000010000000100110010001001
00000000001000100000011000000000110010001001
00000000001000100000011000000100100010001001
00000000001000000010011000000000111000001001
00000000000010000010010100000100101000001001
00000000001000000010010100100000101000001001
00000000001000010010010000100000101000001001
00000000001000010010010100000000101000001001
00000000000100000010011000000100110000001001
00000000001000000010011100000000110000001001
00000000001000000010110000000011100000001001
00000000010000000010110000000101100000001001
00000000001000000011110000000001100000001001
00000000001000010010010100100000100000001001
00000000001000001000010000001000110000110001
00000000001000000100010000010000110000110001
00000000001000001000011000000000110000110001
00000000001000001001010000000010100000110001
00000000001000001100000000011000100000110001
00000000001000001000011000001000100000110001
00000000001000000100011000010000100000110001
00000000001000001100010000011000000000110001
00000000001000000100010000100001100001010001
00000000001000010001010000000010100001010001
00000000001000010100000000101000100001010001
00000000001000000100110000100000100001010001
00000000001000010100010000101000000001010001
00000000001000000100010010000001100100010001
00000000001000000100110000000001100100010001
00000000001000000100110010000000100100010001
00000000000010000100010100001000101000010001
00000000000100000100011000001000110000010001
00000000001000001100010000010000110000010001
00000000010000000100110000001001100000010001
00000000001000010100010000100001100000010001
00000000001000000100110010000001100000010001
00000000001000001100011000010000100000010001
00000000001000010100110000100000100000010001
00000000001000001000010100000000101010100001
00000000001000001000010101000000101000100001
00000000001000001000011000001000110000100001
00000000001000001100010000001000110000100001
00000000001000001100011000000000110000100001
00000000010000001000110000010001100000100001
00000000001000001001010000001010100000100001
00000000100000001001010000010010100000100001
00000000001000001101010000000010100000100001
00000000001000001100011000001000100000100001
00000000100000010001010000100010100001000001
