00000000000010111
00000000000011011
00000000000100111
00000000000101011
00000000001001101
00000000001010011
00000000010000111
00000000010001011
00000000010001101
00000000010010011
00000000010010101
00000000010100011
00000000010100101
00000000011000011
00000000100000111
00000000100001011
00000000100001101
00000000100010101
00000000100011001
00000000100100011
00000000100100101
00000000101000011
00000000101000101
00000001000000111
00000001000001101
00000001000010011
00000001000011001
00000001000100011
00000001000100101
00000001000101001
00000001000110001
00000001001000011
00000001001000101
00000001010000011
00000010000001011
00000010000010011
00000010000010101
00000010000011001
00000010000100011
00000010000100101
00000010000101001
00000010000110001
00000010001000011
00000010001000101
00000010001001001
00000010010000101
00000010100000011
00000100000100011
00000100000100101
00000100001000011
00000100001000101
00000100001001001
00000100010000101
00000100010001001
00000100010010001
00000100100001001
