0000010101010100010001000101000101010101
0000010101010001010001000100010101010101
0000010101010001000101000101010001010101
0000010101010001000100010100010101010101
0000010101001001110000011000100100001101
0000010101000101010100010100010001010101
0000010101000101010100010001010001010101
0000010101000101010001000101000101010101
0000010101000101000101000100010101010101
0000010101000101000100010101010100010101
0000010101000101000100010101010001010101
0000010101000101000100010101000101010101
0000010101000100010101010001010001010101
0000010101000100010100010101010001010101
0000010101000100010100010100010101010101
0000010101000100010100010001010101010101
0000010101000011011000010010001100000111
0000010101000011010000110010000100100111
0000010101000001011101000100010100010011
0000010101000001011001000101000100010111
0000010100100100001001100001011000110101
0000010100100001001000110100001101100101
0000010100011100000111001000010010001101
0000010100010110000101100010010000100111
0000010100010101010101010001000100010101
0000010100010101010101000101000100010101
0000010100010101010101000100010001010101
0000010100010101010100010101000100010101
0000010100010101010100010100010001010101
0000010100010101010001010101000100010101
0000010100010101010001010001000101010101
0000010100010101010001000101010101000101
0000010100010101010001000101010001010101
0000010100010101010001000101000101010101
0000010100010101000100010101010100010101
0000010100010101000100010101010001010101
0000010100010101000100010100010101010101
0000010100010100010101010101000100010101
0000010100010100010101010001000101010101
0000010100010100010100010001010101010101
0000010100010100010001010101010101000101
0000010100010100010001010101000101010101
0000010100010100010001000101010101010101
0000010100010001011001000101010000010111
0000010100010001010101010101000101000101
0000010100010001010101010101000001010101
0000010100010001010101010100010100010101
0000010100010001010101010100000101010101
0000010100010001010101010001000101010101
0000010100010001010101000101010100010101
0000010100010001010101000101000101010101
0000010100010001010101000100010101010101
0000010100010001010101000001010101010101
0000010100010001010100010101000101010101
0000010100010001010100010100010101010101
0000010100010001010001010101010100010101
0000010100010001010001010101000101010101
0000010100010001010001000101010101010101
0000010100010001000101000101010101010101
0000010100010001000100010101010101010101
0000010100001100100001001001110000011101
0000010100001001000010011100000111001101
0000010100000110001001000011011000010111
0000010100000101010101000100010101010101
0000010100000101010100010001010101010101
0000010100000101010001000101010101010101
0000010100000101000100010101010101010101
0000010011010001000101000101110000010101
0000010010100001000101000001110011011001
0000010010011101100001001000110000010101
0000010010011101000011001000110000010101
0000010010001100100101011000110000010101
0000010010001100000111011000110000010101
0000010010001100000111001001010110000101
0000010010000100100111000001110110000101
0000010001100101000010001000011011000111
0000010001100010010010000010100001111101
0000010001011010011001000110100000101001
0000010001010101010101010000010101000101
0000010001010101010101000101010100000101
0000010001010101010101000101010000010101
0000010001010101010101000101000100010101
0000010001010101010101000101000001010101
0000010001010101010101000100010001010101
0000010001010101010100010101010001000101
0000010001010101010100010101010000010101
0000010001010101010100010101000001010101
0000010001010101010100010100010100010101
0000010001010101010100010001010101000101
0000010001010101010100010001010100010101
0000010001010101010100000101010100010101
0000010001010101010100000101010001010101
0000010001010101010001010100010100010101
0000010001010101010001010100010001010101
0000010001010101010001010100000101010101
0000010001010101010001000101010100010101
0000010001010101010000010101010100010101
0000010001010101010000010101000101010101
0000010001010101000101010100010101000101
0000010001010101000101010001010101010001
0000010001010101000101000101010101000101
0000010001010101000101000101010001010101
0000010001010101000100010101010101000101
0000010001010101000100010101010100010101
0000010001010101000100010101000101010101
0000010001010101000001010100010101010101
0000010001010100010101010100010101010001
0000010001010100010101010100010100010101
0000010001010100010101010001010101000101
0000010001010100010101010000010101010101
0000010001010100010101000101010101010001
0000010001010100010101000101010100010101
0000010001010100010101000101010001010101
0000010001010100010101000001010101010101
0000010001010100010100010101010101010001
0000010001010100010100010101010001010101
0000010001010100010100010001010101010101
0000010001010100000101010101010101010001
0000010001010100000101010101010101000101
0000010001010100000101000101010101010101
0000010001010100000100010101010101010101
0000010001010011110000010100110010001001
0000010001010001011101000101010000010011
0000010001010001010101010101010000010101
0000010001010001010101010101000100010101
0000010001010001010101010100010101000101
0000010001010001010101010001010100010101
0000010001010001010101000101010100010101
0000010001010001010100010101010101010001
0000010001010001010100010101010001010101
0000010001010001010100010101000101010101
0000010001010001010100010100010101010101
0000010001010001010100010001010101010101
0000010001010001010100000101010101010101
0000010001010001010001010101010100010101
0000010001010001010001010100010101010101
0000010001010001010000010101010101010101
0000010001010001001101000101010000010111
0000010001010001000100010101010101010101
0000010001010000100101111100001000100011
0000010001010000010101000101010101010101
0000010001001010001110110001000001000111
0000010001000101110100010101010000011001
0000010001000101100100010101010000011101
0000010001000101010101010101010000010101
0000010001000101010101010101000001010101
0000010001000101010101010100000101010101
0000010001000101010101010001010001010101
0000010001000101010101000101010101010001
0000010001000101010101000101010100010101
0000010001000101010101000101000101010101
0000010001000101010101000100010101010101
0000010001000101010101000001010101010101
0000010001000101010100010101010101000101
0000010001000101010100010101010001010101
0000010001000101010100000101010101010101
0000010001000101010001010100010101010101
0000010001000101010000010101010101010101
0000010001000101000101000101010101010101
0000010001000100010101000101010101010101
0000010001000100000100101101110110000011
0000010001000010101001111000100000101101
0000010001000001011101000101010100010011
0000010001000001001101000101010100010111
0000010000110111001001000010011000010101
0000010000110111000001100010011000010101
0000010000101110000010011100010110001001
0000010000100110001101010010011000010101
0000010000100110000101110010011000010101
0000010000100110000101100011010100100101
0000010000100101101100010000101110010001
0000010000100100001101100001011100100101
0000010000100010101001011000100001001111
0000010000010101100011001000010010011101
0000010000010101010001010101000101010101
0000010000010101010001010100010101010101
0000010000010101010001000101010101010101
0000010000010101010000010101010101010101
0000010000010101001001100010010000110111
0000010000010101000101010101000101010101
0000010000010101000100010101010101010101
0000010000010011000010001100100101010111
0000010000010001010101010101000101010101
0000010000010001010101010100010101010101
0000010000010001010101000101010101010101
0000001100100001011000110100010100000111
0000001100100001011000010100010100100111
0000001100100001010000010110010100100111
0000001100011011100000100000101010010011
0000001100011010100000100000101110010011
0000001100011010000110101000001010010011
0000001100011010000010101001001010010011
0000001100010010100100111000101000001011
0000001100010010100100101000101000011011
0000001100010010100000101001101000011011
0000001100001010000010111001001010010011
0000001100000101000001110110000101100011
0000001100000100010100001000011011110011
0000001010100100001000001011010001110011
0000001010100000101110100010100010001011
0000001010001010000100111001101000010011
0000001010001010000100111000101100010011
0000001010001010000100110001001010011011
0000001010001010000100110000001110011011
0000001010001000101110100010101000001011
0000001010000011100110100001101100000011
0000001010000011100010110001101000010011
0000001001110100101000001010010000110011
0000001001100000011000110000101111000101
0000001001000101000100001001001011100111
0000001001000001010010001010001110111001
0000001000101100011000100001101101000011
0000001000101010010000100111001100001101
0000001000100011010010110110000011000101
0000001000100010110101001000001101100011
0000001000100001001110001010001010011011
0000001000011100100100101011100000100101
0000001000011010010101010010110001000011
0000001000010111010100000110010100110001
0000001000010011000101000110000101110101
0000001000010010101010000011010010001111
0000001000010001011101000010010101010011
0000001000001101101011000000110111000001
0000001000001011101011000110010010001001
0000001000001011100101010000110100110001
0000001000001011000110101001001110000011
0000001000001011000010111001001010010011
0000001000001010100100110001101010010011
0000001000001010100100110000101110010011
0000001000000101101101000010101000110011
0000000110001001010000010011000011110011
0000000110000010001000100101001011100111
0000000101100100010000001010011100010111
0000000101010100010101000101000101010101
0000000101010100010100010101000101010101
0000000101010100010100000101010101010101
0000000101010100000101000101010101010101
0000000101010001010101010001010001010101
0000000101010001010101000101000101010101
0000000101010001010100010100010101010101
0000000101010001010001010101010100010101
0000000101010001010001010001010101010101
0000000101010001010001000101010101010101
0000000101010001010000010101010101010101
0000000101010001000101000101010101010101
0000000101010000010100010101010101010101
0000000101000111001101000101000000110011
0000000101000111001000110000001101100101
0000000101000111001000010010001101100101
0000000101000110000100000111110100001011
0000000101000101110100010101010000001101
0000000101000101100010011000000111001101
0000000101000101100010010000100111001101
0000000101000101010101010101000001010101
0000000101000101010101010100010001010101
0000000101000101010101010001010100010101
0000000101000101010101010001010001010101
0000000101000101010101010001000101010101
0000000101000101010101000101000101010101
0000000101000101010101000100010101010101
0000000101000101010101000001010101010101
0000000101000101010100010101010001010101
0000000101000101010100010101000101010101
0000000101000101010001010101010001010101
0000000101000101010001000101010101010101
0000000101000101001000110110010100100011
0000000101000101001000110100011100100011
0000000101000101001000110010000101100111
0000000101000101001000110000001101100111
0000000101000101000101010001010101010101
0000000101000101000101000101010101010101
0000000101000101000100010101010101010101
0000000101000100110100010101010000011101
0000000101000100010101010001010101010101
0000000101000100010100010101010101010101
0000000101000011011001010010011100000011
0000000101000011010001110010010100100011
0000000101000001110100010101010001001101
0000000101000001010101010001010101010101
0000000101000000110100010101010001011101
0000000100111110001001000101001100000101
0000000100110000111101100100000010100101
0000000100110000001010000001101011101011
0000000100101100110011000011000001010101
0000000100100011011001010010001101000101
0000000100100011010001110010001101000101
0000000100100011010000110110010100100101
0000000100100011000101000101001001110101
0000000100100010001110001001001010101011
0000000100100001011000110100011100100101
0000000100100000010111100001100001010111
0000000100011100110100000101010110001001
0000000100011010100101000011011000011001
0000000100011010000010000100101110010111
0000000100011000000101000011001010011111
0000000100010110011100000101010100100011
0000000100010101010101010101000001010101
0000000100010101010101010001010001010101
0000000100010101010101000101010100010101
0000000100010101010100010101010101000101
0000000100010101010100010101010001010101
0000000100010101010001010101000101010101
0000000100010101010000010101010101010101
0000000100010100111010011100000001001101
0000000100010100101101010000100110100011
0000000100010100010101010001010101010101
0000000100010100010100010101010101010101
0000000100001101100001011100100101001001
0000000100001101000011011100000111001001
0000000100001100100100101010000100101111
0000000100001011000000011001111000110101
0000000100001001110011010000100111000101
0000000100001001110001011000100111000101
0000000100001001110000011100110100001101
0000000100001001100101000101000011011101
0000000100001001010010011100010110001101
0000000100000111011000110000011101100001
0000000100000111011000010010011101100001
0000000100000111001001010110001101000011
0000000100000111000001110110000101100011
0000000100000101110010011000010111001001
0000000100000101110010010000110111001001
0000000100000101011000110010010101100011
0000000100000101011000110000011101100011
0000000100000101010101010101000101010101
0000000100000011011001110000001101100101
0000000100000011011001010010001101100101
0000000100000011011000010110011100000111
0000000100000011010000110110010100100111
0000000100000001011001110010000101100111
0000000100000001011001110000001101100111
0000000011000010110101010010010000010111
0000000010011100001100101000100110001101
0000000010010011100100010100111000011001
0000000010010010000111000000110111010101
0000000010010001110101000000110101011001
0000000010001001011110011100001000100011
0000000010000101100111001010100000011011
0000000010000100010001100010100110101111
0000000010000011000101010010010110111001
0000000001010101000101010001010101010101
0000000001010100010101010100010101010101
0000000001010100010101010001010101010101
0000000001010100010101000101010101010101
0000000001010100010100010101010101010101
0000000001010001010101010100010101010101
0000000001010001010100010101010101010101
0000000000110001001101101000010101000111
0000000000110001001101000100001101010111
0000000000101000010100001100110100111101
0000000000100101101100011000110100010011
0000000000100100101100011100100011010101
0000000000011000110100101011000001101011
0000000000001001110101100001101100001011
