00000001010010110100011110011011
00000001010011111010000101100111
00000001010110110100011100011011
00000001100010110101001101001111
00000001100010110101001101011011
00000001101000011001010110110111
00000010001011000110101001111101
00000010010011110010101101100011
00000010011000110010101101001111
00000010011000111100001011101011
00000010011000111110001011010011
00000010011010111100001011010011
00000010011010111100001011100011
00000010100011001100001011011111
00000010100011100100001011011111
00000010100011110101001010011011
00000010110011100001011011001011
00000010110100111110001001100011
00000011000010110101000111001111
00000011000010110101000111011011
00000011010001100010101101101011
00000011010010010101001110011011
00000011010010110010101001100111
00000011010110110100010100011011
00000011011000101000101101001111
00000100011011000001110101101101
00000100011011000100111100101101
00000100100001101100010111100111
00000100111100101100011010100011
00000101000011110011100100011011
00000101000110110011100100001111
00000101000111001000010110111011
00000101001011000100111001101101
00000101010110110100001100011011
00000101100001101000010011110111
00000101110001101000010011010111
00000101110101101000010011000111
00000101111001101100010010000111
00000110110010100001001011001111
00000110110010101001000011001111
00001000010011111000101110001101
00001000100011010010110010101111
00001000100011011000101101001111
00001000100011110010110010101101
00001000110100010101001011111001
00001000111110001110100001011001
00001001000010110011010100011111
00001001000101110000110101011011
00001001000111110000110101010011
00001001000111110010110101000011
00001001000111110011010100001011
00001001010000111101101100010011
00001001010011001000101110001111
00001001010101110000110100011011
00001001010111110000110100010011
00001001011001111100001001100101
00001001110001111000100101100101
00001001110011101000101100001101
00001001111001011000100101000111
00001010001011000100101001111101
00001010011011110010001101000011
00001011000011101000100111001101
00001011010001110010001001101011
00001011010010100010001101100111
00001011010011011000100010001111
00001011010100010100111100010011
00001011011000100010001101001111
00001011011010110010001001000111
00001011100011001000100101001111
00001100100011010010100010101111
00001101010010110010100100010111
00001101111001001000100101000111
