000000001000000011000000001000000111000000111
000000001000000001000000111000000011000000111
000000001000000101000000011000000011000000111
000000001000000011000000011000000101000000111
000000001000100001000000001000100011000100011
000000001000100001000100001000000011000100011
000000001000000001000100011000100001000100011
000000001000000011000100001000100001000100011
000000001000000101000000011000000111000000011
000000001000000011000000101000000111000000011
000000001000000111000000101000000011000000011
000000001000000011000000111000000101000000011
000000001000100001000100011000100001000000011
000000001000100011000100001000100001000000011
000000001000000101000000001000010101000010101
000000001000000001000010101000000101000010101
000000001000010001000000101000000101000010101
000000001000000101000000101000010001000010101
000000001000000011000000111000000011000000101
000000001000000111000000011000000011000000101
000000001000010001000000101000010101000000101
000000001000000101000010001000010101000000101
000000001000010101000010001000000101000000101
000000001000000101000010101000010001000000101
000000000000001001001000001001001001001001001
000000000001000001001000001001001001001001001
000000000001001000001000001001001001001001001
000000001000001000001000001001001001001001001
000000001000001001000000001001001001001001001
000000000001001000001001000001001001001001001
000000001001000001000001000001001001001001001
000000001000001001001000000001001001001001001
000000000001000001001001001000001001001001001
000000001000000001001001001000001001001001001
000000000001001000001001001000001001001001001
000000001000001000001001001000001001001001001
000000000001001001000001001000001001001001001
000000001001000001000001001000001001001001001
000000001001000001001000001000001001001001001
000000000001000001001001001001000001001001001
000000000001001000001001001001000001001001001
000000001000001000001001001001000001001001001
000000001000001001000001001001000001001001001
000000001000001001001000001001000001001001001
000000001001001000001000001001000001001001001
000000001001000001001001000001000001001001001
000000001001001000001001000001000001001001001
000000000001000001001001001001001000001001001
000000001000001000001001001001001000001001001
000000001000001001000001001001001000001001001
000000001001000001000001001001001000001001001
000000001000001001001000001001001000001001001
000000001000001001001001001000001000001001001
000000001001000001001001001000001000001001001
000000001000001001001001001001000000001001001
000000001000001000001001001001001001000001001
000000001001000001000001001001001001000001001
000000001000001001001000001001001001000001001
000000001000001001001001000001001001000001001
000000001000001001001001001001000001000001001
000000001000001001001001001001001000000001001
000000001000010001000010001100000001100010001
000000001000000101000010101000000101000010001
000000001000010101000000101000000101000010001
000000001000010001100000001100010001000010001
000000001000010001100010001100000001000010001
000000001000000011000100001000100011000100001
000000001000001001001000001001001001001000001
