000001010111101111111100101110101011
000010100110111011000111111011111011
000010101110111011000111110011111011
000100101100111010110011111110011111
000100110111101111010110011111100101
000101001110110011110011110110111101
000110011111100101010100110111101111
000110100111011111100100111101010111
000110110111011111100100101101010111
