000000000100100001000100011101001000100001011
000000001000011000001000010100000011101010011
000000100000010001000000101100001000100111101
000000100000010010100010000100010101110000011
000000100000110001000100001001001000000111101
000000100100001100001000101010000001110001001
