00000010111010111111001011110111
00000101011111001011111001110111
00000101110101110010111101110111
00000101110111011010110111010111
00000110110101101110110111010111
00000111010111111011100101001111
00001001011100110001111111011111
00001001100110100111101011111111
00001010001111101101011110111011
00001010011011111000111110111101
00001010100111101101110011111011
00001010111010110001111110111011
00001010111011000111110011111011
00001011000111011111110100110111
00001011001010110110111011110111
00001011010111111101100101100111
00001011011101010001111111001111
00001011011111100111001101011101
00001011101011111101101001110011
00001011110011110111001011101011
00001011110110110001110101110111
00001100101010111011010110111111
00001100101011111100101111100111
00001100101011111110100110011111
00001100111011011011010101011111
00001101000111011100101111110111
00001101010101110010011111110111
00001101111111011000110101010111
00001110010110110011010101111111
00001110101010010011101111011111
00010001001111010110111110011111
00010001011111001011110110110111
00010001100111110101011111011011
00010001110110110101011110011111
00010010011111010111110001101111
00010010110111111101110001111001
00010010111011101011011010011111
00010011001111010101111101111001
00010011001111011101011010011111
00010011010011010110101111011111
00010011010011111010110101011111
00010011010101111001001111011111
00010011010101111001101101011111
00010011010110011010111101011111
00010011010111110001101111010111
00010011010111111001001111010111
00010011010111111101100100101111
00010011011110010101111100111101
00010011100110010101011111011111
00010011100110110101011111011101
00010011100111110101010111011011
00010011110101111001101101010111
00010011110110110101010110011111
00010011110111010101011110011011
00010011110111110001101101010111
00010011111101011001110110100111
00010011111110110110100011101011
00010100010110110111100111111011
00010100100111110111101001110111
00010100111101001110111001111101
00010100111101011111011000111011
00010101001110111100111101011011
00010101100110110101001111011111
00010101101100111100111110110101
00010101101100111101000111110111
00010101110111110101001110011011
00010101111011100111110001101101
00010101111101111101000110110011
00010110001101111111101001011101
00010110010011101011010111110111
00010110010111111011010001110111
00010110011101010011010011111111
00010110011101010011111011010111
00010111000110101001011111111101
00010111001110010101101101111101
00010111010100111001011111011011
00010111010100111001111101011011
00010111010100111111100111001011
00010111010110110001111111010011
00010111010110111001011111010011
00010111011001010011010111101111
00010111100111010101001111011011
00010111101001011001100111110111
00010111110100111001111101010011
00010111110110010101001110011111
00010111110110110001111101010011
00010111111011010011010101100111
00011001010111010011100101111111
00011001010111010011101101011111
00011010010101011111110011011011
00011010010111011101010011111011
00011010101001001011111110110111
00011010101111100111001001101111
00011011010111111001001101010111
00011011101010010010111011011111
00011011101010100100101110111111
00011011110101111001001101010111
00011101010011011001010111101111
00011101010011101001001111011111
00011101101010010011011101011111
