000000000000011
000000000000101
000000000001001
000000000010001
000000000100001
000000001000001
000000010000001
