0000011011010111
0000100110101111
0000110010101111
0000110101011011
0001001101010111
0001011101010011
