00001101110111111111
00001101111110111111
00001110110111111111
00001110111011111111
00001110111101111111
00001110111110111111
00001111011101111111
00010011111111011111
00010110110111111111
00010110111101111111
00010111100111111111
00010111101111011111
00010111110111101111
00010111110111111011
00010111111011110111
00010111111101101111
00010111111111001111
00011001111101111111
00011010110111111111
00011010111101111111
00011011010111111111
00011011011011111111
00011011011101111111
00011011101011111111
00011011101111101111
00011011110111011111
00011011110111101111
00011011111001111111
00011011111010111111
00011011111011011111
00011011111101011111
00011011111101101111
00011011111101110111
00011011111110101111
00011011111111001111
00011100110111111111
00011101011011111111
00011101100111111111
00011101101011111111
00011101101101111111
00011101101111110111
00011101110110111111
00011101111011011111
00011101111101101111
00011110011011111111
00011110110011111111
00011110110111011111
00011110111011011111
00100101111011111111
00100101111110111111
00100101111111011111
00100111010111111111
00100111011111011111
00100111100111111111
00100111101011111111
00100111101110111111
00100111101111011111
00101010111011111111
00101011011011111111
00101011100111111111
00101011101110111111
00101011110011111111
00101011110111101111
00101011110111111011
00101011111001111111
00101011111010111111
00101011111011011111
00101011111011110111
00101011111011111101
00101011111101101111
00101011111110011111
00101011111111001111
00101011111111100111
00101100111011111111
00101101010111111111
00101101100111111111
00101101101110111111
00101101101111110111
00101101110011111111
00101101110101111111
00101101110110111111
00101101110111011111
00101101110111101111
00101101110111111101
00101101111011110111
00101101111101110111
00101101111110111011
00101101111111010111
00101101111111100111
00101110010111111111
00101110011011111111
00101110011111111011
00101110011111111101
00101110110101111111
00101110110111101111
00101110110111111101
00101110111001111111
00101110111011101111
00101110111011110111
00101110111011111101
00101110111100111111
00101110111101111011
00101110111110110111
00101110111110111101
00101111001110111111
00101111010111011111
00101111010111110111
00101111010111111011
00101111011011101111
00101111011011111011
00101111011101111101
00101111011110111011
00101111100111011111
00101111100111110111
00101111101011110111
00101111101110011111
00101111101110101111
00101111101110110111
00101111110011101111
00101111110011110111
00101111110101110111
00101111110101111011
00101111110110110111
00101111110111001111
00101111110111100111
00101111110111101011
00101111111010101111
00101111111011001111
00101111111011010111
00101111111011100111
00101111111011110011
00101111111100111011
00110011010111111111
00110011101011111111
00110011110101111111
00110011111010111111
00110101010111111111
00110101011011111111
00110101101011111111
00110101101111011111
00110101101111110111
00110101110110111111
00110101110111011111
00110101111001111111
00110101111010111111
00110101111011011111
00110101111011110111
00110101111101011111
00110101111110011111
00110101111110110111
00110101111111001111
00110101111111011011
00110110101011111111
00110110101111011111
00110110101111111011
00110110110101111111
00110110111101011111
00110110111111010111
00110111010110111111
00110111010111101111
00110111010111110111
00110111101011011111
00110111101011101111
00110111101011111011
00110111101101011111
00110111101111010111
00110111110110101111
00110111110111010111
00110111111010101111
00110111111011010111
00110111111101010111
00111010110101111111
00111010110110111111
00111010110111101111
00111010111101101111
00111011010111011111
00111011010111101111
00111011010111110111
00111011011010111111
00111011101011011111
00111011110101101111
00111011110110101111
00111101010110111111
00111101011011101111
00111101101010111111
00111110101011011111
