000000000000100001000100011
000000000000100010000100011
000000000001000001001001001
000000000001001000001001001
000000000010000001010100001
000000000010000101000000101
000000000100000001110000001
000000000100000011000000011
000000001000000001000000111
000000001000000001000010101
000000001000000001000100011
000000001000000001001001001
000000001000000010000000111
000000001000000011000000011
000000001000000011000000101
000000001000000011000100001
000000001000000100000010101
000000001000000101000000011
000000001000000101000000101
000000001000000101000010001
000000001000001000001001001
000000001000001001000001001
000000001000001001001000001
000000001000010000100010001
000000001000010001000000101
000000001000010001000010001
000000001000100001000000011
000000001001000001000001001
