00001110111111
00010110111111
00010111101111
00011010111111
00011011011111
00011011101111
00011101101111
00100111011111
00101010111111
00101011011111
00101100111111
00101101110111
00101110011111
00101110101111
00101110110111
00101110111101
00101111010111
00101111011011
00101111100111
00101111110011
00110101011111
00110101111011
00110110101111
00110111010111
00111010110111
