001111110111111111110101101111101110110111111111111111111111111
001110111101111101011111111111011111101101111111111111111111111
001111111101101101011111111111011111101110111111111111111111111
001111111111111111101101101111111010101111011111111111111111111
001101111111110111101111110111111110101111101111111111111111111
001111111111011111111011011101011111110111101111111111111111111
001111111110111111111101011011101111111011111011111111111111111
001111111101111111111111011011110111111011101011111111111111111
001110110110111111110111111111111011111111111010111111111111111
001111010111011111111111110110111111111011111111011111111111111
001111110101101111111111011111011111111111111011101111111111111
001111111110101110110111111111111111111110111101101111111111111
000111011011111111011111111110111111111011111111110111111111111
000111111110111110111111111111111111110111011011110111111111111
000111011111111111111111111111011111110110111111010111111111111
001011110111110110111111111111111111111110111011111011111111111
001011111011111111111111101111110111011111111101111011111111111
001111111011111111011111111111111111101110101111011011111111111
001011111111111011101111001111110111111111111111111101111111111
001001111101111111101111111011110111111111111111111101111111111
001101011111110111111111011111111111011111101111111101111111111
001101111111111111111111111111011111011011110101111101111111111
001111111101111110101110111111111111111111110111101101111111111
001111110110111111111111111111111101111111101110101101111111111
001111110101110111111111110110101111111111111111111110111111111
000111010111111111110111111111111111110110111111111111011111111
001101101111011111111111111110101111111111111111101111011111111
001011111011111111111101111110111011111111111111101111011111111
001011111011111111111101111111111111110111011111101111011111111
001101111111011111111111101111101111111111111110101111011111111
001011111011111111111111111101111011111111101111110111011111111
001111110111101101111111111111111101111111111111011101011111111
001111101110111111111111101011011111111111011111111111101111111
001110101111111111011011111111111011111111111011111111101111111
001101111111110101111011111011111111111111111101111111101111111
001101011111111101111111111111111110111111011101111111101111111
001111101111101110111111111111111111111110110101111111101111111
001111011111101101111111111111111111111111010101111111101111111
001011111111111101111110111101111111111111111011101111101111111
001111101111111110111111111101101011111111111111111011101111111
001111101111111111011010111111111111111111111011111011101111111
001111110101110111111111111111111110111101111111111101101111111
001111101111011111111111111111111111010111011111111101101111111
001111101101111111111101110111111111111111111111110110101111111
001101101111111111111111111101111011111111111111111010101111111
001111101111111111111011101111111111111111111111011010101111111
001110111111111011011011111111111111111111111010111111110111111
001011111111111111111111110111111110111011110111110111110111111
001011111111111111101111011111011111111011111111111101110111111
001110111111010111111111111111011111011111111111111110110111111
001101111011111111110101111111111101111101111111111111111011111
001111101011011111111111111111101111111111101110111111111011111
001101111011111111111101111111111111110101111111111101111011111
001101111111111011110111111111111011111101111111111111101011111
001111011011101101111111111111111010111111111111111111111101111
001101111111110101111111011111101111111111011111111111111101111
001011101111111110111111111111111101111111101011111111111101111
001011111111111011101111110111111111011111111111101111111101111
001011111101111111101110111011111111111111111111111101111101111
001101111111111111111011111110101111111111111011111101111101111
001101111111111111111111011111101111111111011111110101111101111
001110111111110111111101101111111111111101111111111111110101111
001101111111111101111011111111101111111111111011111111110101111
001011111011111011111111101111111111011111111101111111111110111
001101101111111111111101111111111111110101111111110111111110111
001011111111111110111011111110111111111111110111111110111110111
001011111011111111111111111101111111111111001111111111011110111
001011111111101111111111111111111101111101111111011111011110111
001011111111111101111101111101111111111111111011111111101110111
001101111101111111111111111110111111111110101111111111110110111
001011110111111111111001111111101111111111111111011111111111011
001011111101111111111011111110111111111111101111011111111111011
