0000000000000001001010111
0000000000000001001101011
0000000000000010001001111
0000000000000100010001111
0000000000000101001000111
0000000000000110000101011
0000000000000110010001011
0000000000001000010110011
0000000000001000111001001
0000000000001001100010101
0000000000010001001001011
0000000000010001001010011
0000000000011000000101011
0000000000011000010001011
0000000000011000010100011
0000000000100000001110101
0000000000100000110001101
0000000000100001000011011
0000000000100001000100111
0000000000100001001001011
0000000000100001010101001
0000000000100001011000011
0000000000100100100100011
0000000000110000000101011
0000000001000000010001111
0000000001000000101100101
0000000001000001100101001
0000000001000100000001111
0000000001000100001001011
0000000001000100010100101
0000000001000101000001011
0000000001000110000001101
0000000001001000000010111
0000000001001000001010011
0000000001001000010100011
0000000010000001001011001
0000000010000011000101001
0000000010000100010101001
0000000010001010000110001
0000000010010000110000101
0000000010010001000100011
0000000010011010000000101
0000000010100000010010011
0000000010100001001000011
0000000010100010000001011
0000000100000001001010101
0000000100000010000001111
0000000100000010111000001
0000000100000011100001001
0000000100000100010010101
0000000100000101001010001
0000000100000101010100001
0000000100000110100000011
0000000100001000000100111
0000000100001000000101011
0000000100001001000001101
0000000100001001000100011
0000000100001001001000011
0000000100001100010001001
0000000100010000110001001
0000000100010001100000101
0000000100010011000001001
0000000100011000100000011
0000000100100000100001101
0000000100100001010000011
0000000100100010000010011
0000000100100010000011001
0000000100110000010000101
0000000101010000010000011
0000001000000100001011001
0000001000000100001110001
0000001000000100010100101
0000001000000100011001001
0000001000000100110000101
0000001000001000001000111
0000001000001000001001011
0000001000001000001001101
0000001000001000010001101
0000001000001000100000111
0000001000001000100010101
0000001000001000111000001
0000001000001001100010001
0000001000001010001000101
0000001000010011000000101
0000001000011000100000101
0000001000100001000001101
0000001000100010001001001
0000001000100100000101001
0000001001000001000001101
0000001001000001000010101
