00000000000000010010111
00000000000000010011101
00000000000000100011011
00000000000000100011101
00000000000000100100111
00000000000000100110101
00000000000000101000111
00000000000000101010011
00000000000001000010111
00000000000001000011101
00000000000001000100111
00000000000001000101011
00000000000001000101101
00000000000001001000111
00000000000001010001101
00000000000001100010011
00000000000010000011011
00000000000010000100111
00000000000010000101011
00000000000010000110101
00000000000010000111001
00000000000010001000111
00000000000010001001011
00000000000010001001101
00000000000010001101001
00000000000010010001011
00000000000010010100011
00000000000010011000101
00000000000010100010011
00000000000010100100011
00000000000010101000011
00000000000010110000011
00000000000100000010111
00000000000100000100111
00000000000100000101011
00000000000100000110101
00000000000100000111001
00000000000100001000111
00000000000100001001011
00000000000100001001101
00000000000100001010011
00000000000100001011001
00000000000100001101001
00000000000100001110001
00000000000100010000111
00000000000100010001011
00000000000100010001101
00000000000100011001001
00000000000100100000111
00000000000100100100011
00000000000100101000011
00000000000100101000101
00000000000101000100011
00000000000101000100101
00000000000101001000011
00000000000101010000011
00000000000101100000011
00000000000110000001011
00000000001000000011011
00000000001000000011101
00000000001000000101011
00000000001000000110101
00000000001000000111001
00000000001000001011001
00000000001000001100011
00000000001000001100101
00000000001000001110001
00000000001000010000111
00000000001000010001011
00000000001000010001101
00000000001000010010011
00000000001000010010101
00000000001000011000101
00000000001000011010001
00000000001000100001011
00000000001000100100101
00000000001000101000011
00000000001000101001001
00000000001001000000111
00000000001001000001011
00000000001001000010101
00000000001001000100011
00000000001001000101001
00000000001001001000011
00000000001001001000101
00000000001001010000011
00000000001001010000101
00000000001010000000111
00000000001010000010011
00000000001010010000011
00000000001010100000011
00000000010000000010111
00000000010000000011101
00000000010000000101011
00000000010000000110101
00000000010000001000111
00000000010000001001101
00000000010000001011001
00000000010000001101001
00000000010000001110001
00000000010000010000111
00000000010000010001011
00000000010000010001101
00000000010000010010011
00000000010000010100011
00000000010000010101001
00000000010000011001001
00000000010000100000111
00000000010000100001011
00000000010000100001101
00000000010000100010011
00000000010000100010101
00000000010000100011001
00000000010000100100011
00000000010000100100101
00000000010000101001001
00000000010000101010001
00000000010000110010001
00000000010001000000111
00000000010001000001011
00000000010001000001101
00000000010001000011001
00000000010001000100101
00000000010001000101001
00000000010001010000011
00000000010001100001001
00000000010010000000111
00000000010010000010011
00000000010010000010101
00000000010010000100011
00000000010010000100101
00000000010010001000011
00000000010010001000101
00000000010010010000101
00000000010010100000011
00000000010100010000011
00000000010100100000011
00000000010101000000011
00000000100000000100111
00000000100000001000111
00000000100000001001011
00000000100000001001101
00000000100000001010011
00000000100000001011001
00000000100000001101001
00000000100000001110001
00000000100000010001101
00000000100000010010011
00000000100000010010101
00000000100000010100101
00000000100000010101001
00000000100000011000101
00000000100000011010001
00000000100000011100001
00000000100000100000111
00000000100000100001101
00000000100000100010011
00000000100000100010101
00000000100000100100011
00000000100000100100101
00000000100000100110001
00000000100000101010001
00000000100000110000101
00000000100000110001001
00000000100000110010001
00000000100000110100001
00000000100001000000111
00000000100001000001011
00000000100001000001101
00000000100001000010011
00000000100001000010101
00000000100001000011001
00000000100001001000011
00000000100001001000101
00000000100001010000011
00000000100001010001001
00000000100001100000011
00000000100001100010001
00000000100010000001101
00000000100010000101001
00000000100010000110001
00000000100010001001001
00000000100010010000101
00000000100011000000101
00000000100011000001001
00000000100100000100011
00000000100100010000011
00000000100100100000101
00000000100101000000011
00000000101000000010011
00000000101000000100011
00000000101000010000011
00000000101000100000011
00000000101001000000011
00000001000000010000111
00000001000000010001011
00000001000000010001101
00000001000000010010011
00000001000000010010101
00000001000000010100011
00000001000000100000111
00000001000000100010011
00000001000000100010101
00000001000000100011001
00000001000000100100101
00000001000000100110001
00000001000000101000011
00000001000000101000101
00000001000000101001001
00000001000000101100001
00000001000001000001101
00000001000001000010101
00000001000001000011001
00000001000001000100101
00000001000001000101001
00000001000001000110001
00000001000001001010001
00000001000001010000101
00000001000001010001001
00000001000001010010001
00000001000001010100001
00000001000001100001001
00000001000001100100001
00000001000010000001011
00000001000010000001101
00000001000010000010011
00000001000010000011001
00000001000010001001001
00000001000010001010001
00000001000010010000011
00000001000010010010001
00000001000010100010001
00000001000011000001001
00000001000011000010001
00000001000100000010101
00000001000100000100101
00000001000100000110001
00000001000100001000011
00000001000100001000101
00000001000100100000011
00000001000100100000101
00000001000110000001001
00000001001000001000011
00000001001000001000101
00000001001000010000101
00000001001000100000011
00000001010000001000011
00000001010000010000011
00000001100000010000011
00000010000001000001011
00000010000001000010011
00000010000001000011001
00000010000001000101001
00000010000001001000011
00000010000010000001011
00000010000010000010011
00000010000010000010101
00000010000010000011001
00000010000010000100011
00000010000010000100101
00000010000010000101001
00000010000010000110001
00000010000010010010001
00000010000010010100001
00000010000010100010001
00000010000010100100001
00000010000011000010001
00000010000011000100001
00000010000100000100011
00000010000100001000101
00000010000100010000011
00000010000100010001001
00000010000100100000101
00000010000100100010001
00000010000101000001001
00000010001000001000011
00000010001000001001001
00000010001000010000011
00000010001000010000101
00000010001000010001001
00000010001000010010001
00000010001000100000101
00000010001000100001001
00000010010000010000011
00000010010000010000101
00000010010000100000101
