0000000000100000100111
0000000000100001011001
0000000000100010000111
0000000000100010001101
0000000000100100100011
0000000000100101000011
0000000000101001000011
0000000000101010000011
0000000001000000101011
0000000001000001010011
0000000001000010010011
0000000001010010000011
0000000010000001000111
0000000010000100000111
0000000010000100001101
0000000010001000001101
0000000010010001000101
0000000010011000000101
0000000010100000100011
0000000100000010001011
0000000100000100010101
0000000100001000011001
0000000100001010001001
0000000100010000001011
0000000100010100001001
0000000100100010000101
0000000101000000100011
0000001000001000010011
0000001000001010010001
0000001000100001001001
0000001001000001000011
