0000001010111011101101101111
0000010011101111010111011101
0000010011110010111101110111
0000010100111101100110111111
0000010110111011010101110111
0000010110111101011101110011
0000010111001101011101101111
0000010111010110101101110111
0000010111010111100101111011
0000010111011100101111010111
0000010111011111100101101011
0000010111111101011100011011
0000011000111101100110111111
0000011010010101110111111011
0000011010110110101110111011
0000011010110110111011101011
0000011011011100110101101111
0000011011100110101110101111
0000011011111101100101001111
0000011011111101100110001111
0000100011011011011101011111
0000100011110100111101110111
0000100011110111011101001111
0000100101011111110011001111
0000100101110111001110011111
0000100110101111100110101111
0000100111011010011101011111
0000100111011010011111010111
0000101000111111100111101101
0000101010111110001111101101
0000101011101001011110111011
0000101011101100011111101011
0000101011101110101101100111
0000101011101111001100101111
0000101011111001110110011011
0000101011111011010110011011
0000101100110010101011111111
0000101100111011111010100111
0000101101010100011111011111
0000101110101100011110111011
0000101110110110001110101111
0000101110111001011011101011
0000101111111010011011000111
0000110011000101011111011111
0000110011001010101011111111
0000110011010100111001111111
0000110011010100111101110111
0000110101000111011101101111
0000110101010110001101111111
0000110101011011111011000111
0000110101011100100111110111
0000110101011101101101100111
0000110101011110110011001111
0000110101011111011001100111
0000110101101000111101110111
0000110101101000111110111011
0000110101111101010100111011
0000110110001011010111110111
0000110110011101010101111011
0000110110011101101101010111
0000110111010001110101111011
0000110111101101010101100111
0000110111110110001101010111
0000111010110110001011101111
0000111011101111000100101111
0000111100010010111011101111
0001000100111101011011111011
0001000101101111011100011111
0001000101110001011111101111
0001000101111001011111100111
0001000101111011110001011111
0001000101111011110010011111
0001000101111110011011010111
0001000111011010011101011111
0001001001011111100101110111
0001001001101011110101011111
0001001001101101011010111111
0001001001111011110001011111
0001001011111101011010011011
0001001100011111011100101111
0001001100110101010111101111
0001001101001101011010111111
0001001101001101011110101111
0001001101011101011010011111
0001001101011101110110001111
0001001101011110011001011111
0001001101011110011011110101
0001001101011111011000101111
0001001101101011110001110111
0001001101101011110101110011
0001001101110111101001111001
0001001101111001111011010101
0001001110100010101111101111
0001001110100110101110101111
0001001110111101010111001101
0001001111010110011011010111
0001001111011101011010011011
0001001111110110110001110101
0001010001101101001111111011
0001010001101101111001111011
0001010001110110010110111111
0001010010110111001111110101
0001010010111100111100111011
0001010010111110111000111011
0001010011011100011110111101
0001010011011110110100011111
0001010011011111001110110101
0001010011011111100101101011
0001010011101100111100101111
0001010011110100011011111101
0001010011110100011110110111
0001010011111110010110011101
0001010100101111001101111101
0001010100110110010111101111
0001010101100100111101111011
0001010101101101001100111111
0001010110011100011111101101
0001010110101001111001111101
0001010110110001111011101101
0001010110110100011111100111
0001010110111001111001101101
0001010111101110110001101101
0001010111110111001101001011
0001011000110111101101011101
0001011000111010010111111101
0001011000111011010011111101
0001011001010101001111111011
0001011001011101110110100111
0001011001111110010100111101
0001011010010111010111110011
0001011010011001110101011111
0001011010011001110101111101
0001011010011101110110010111
0001011011100101011110011101
0001011011111010011000111011
0001011100011010010111111101
0001011101001110011101011011
0001011110011100100100111111
0001011110101100100111110011
0001011110110101010011001111
0001011110110110010101001111
0001011111001100100111101011
0001011111010011001011010111
0001100101010100111011011111
0001100101011110010011011111
0001100101101001110101011111
0001100110100101011111011011
0001100111010100101100111111
0001101001111101010010111011
0001101010010110011111100111
0001101011101101010010011111
0001101101010110010011110111
0001101101111101010010010111
0001101110101001001011101111
0001101110110111010100100111
0001101111011001010101001111
0001101111101101010010010111
0001101111110110010100100111
0001110010101100110100111111
0001110101001001001101111111
0001110101011001001011110111
0001110110011010010101110111
