0000000000010000000100000001010101
0000000000000001000001000100010101
0000000000010000010000000100010101
0000000001000000010000000100010101
0000000001000100000001000000010101
0000000000000001000001010001000101
0000000000000001010000010001000101
0000000001000100000001000001000101
0000000001000100000100000001000101
0000000000000100000100010100000101
0000000001000000000100010100000101
0000000001000000010100000100000101
0000000000010001010001000000000101
0000000001000000000100000101010001
0000000001000001000001000100010001
0000000000000100000001010101000001
