0000000000000000000100000001010001000101010101
0000000000010000000100000000010001000101010101
0000000000000001010000000001000100000101010101
0000000000000001010000010001000000000101010101
0000000000000000010000010000010100010001010101
0000000000010000000100000000010100010001010101
0000000000000100000000010100000100010001010101
0000000000000000010100000100000100010001010101
0000000000000001000100000001010000010001010101
0000000000000100010000000001010000010001010101
0000000000010001000100000000000101000001010101
0000000000000001000001010000010001000001010101
0000000001000100000001000001010000000001010101
0000000001000001000100000000010000010100010101
0000000000000001000001010000000101000100010101
0000000000010000010100000000010001000100010101
0000000000010000000000010101000001000100010101
0000000001000100000100000001000001000100010101
0000000000010100000100000001000100000100010101
0000000000000001000100000001000101010000010101
0000000000010000010000000100010001010000010101
0000000000000100010000010000010001010000010101
0000000000000100010001000001000001010000010101
0000000000010000000100000101000100010000010101
0000000001000000010000010100000100010000010101
0000000000010001000001000101000000010000010101
0000000001000000000101000001010001000000010101
0000000000000100000100010101000001000000010101
0000000000000001000101000101000001000000010101
0000000001000000000101000101000001000000010101
0000000001010001000100000100000001000000010101
0000000001000100000100000001000000010101000101
0000000001000100000100000000010001000101000101
0000000001000100000001000001000001000101000101
0000000001000000010000010100000001000101000101
0000000000010001000000010100000001000101000101
0000000000010000010001000000010100000101000101
0000000000010001000000010000000101010001000101
0000000001000100000001000001000001010001000101
0000000000010000000100010100000001010001000101
0000000000000000010001010000010101000001000101
0000000000000100010001000000010101000001000101
0000000000010000000101000001010001000001000101
0000000000000001000101010000010100000001000101
0000000001000100000001010100000100000001000101
0000000001000001010100000100000100000001000101
0000000000000100010000000000010101010100000101
0000000000010001000000000100010001010100000101
0000000000000001000101000100000001010100000101
0000000001000000000100010101000000010100000101
0000000000000100000101000001010001000100000101
0000000000010001010000010000010001000100000101
0000000000000100010101000000010100000100000101
0000000000000100010000010101000100000100000101
0000000001000000010001000101000100000100000101
0000000000010001010101000000000100000100000101
0000000000010001000101000100010000000100000101
0000000000010001010001000101000000000100000101
0000000000010001000100000101000001010000000101
0000000000000100010100010000010100010000000101
0000000000010001010001000001000100010000000101
0000000001000001000001010100000100010000000101
0000000000010001010001010000000100010000000101
0000000001000001010101000000000100010000000101
0000000000010001010101000000010000010000000101
0000000000010000010100000101010001000000000101
0000000000010000010100010001010001000000000101
0000000000010000010001010001010100000000000101
0000000000000100000001010000010000010101010001
0000000000000000010001010000000101000101010001
0000000000000100000001010000010001000101010001
0000000001000100000001000000010001000101010001
0000000000000100010000010100000001000101010001
0000000000000100000100000100010100000101010001
0000000001000000010001000100000100000101010001
0000000001000000010000010001010000000101010001
0000000001000001000100000001010000000101010001
0000000000010000000101000001000100010001010001
0000000001000000000100000101010001000001010001
0000000000000100000101000001010001000001010001
0000000000000001000100010101000001000001010001
0000000000000001000001010001010100000001010001
0000000000010000000001010100010100000001010001
0000000001000001000100010001010000000001010001
0000000000010000010000000001010100010100010001
0000000000010000000001010001010000010100010001
0000000000000001000001010101000000010100010001
0000000000010000010100010100000000010100010001
0000000000000100010000010000010101000100010001
0000000001000001000001000000010101000100010001
0000000001000000010100000100010100000100010001
0000000000010000000001000001010101010000010001
0000000001000001000100000001000101010000010001
0000000000000100000101000100000101010000010001
0000000000010000010100010101000100000000010001
0000000000010000010001000100000001010101000001
0000000001000000010101000100000100000101000001
0000000001000000010000010101010000000101000001
0000000000010000000100000001010101010001000001
