00000001101111
00000001110111
00000010101111
00000010110111
00000010111011
00000011010111
00000100110111
00000100111101
00000101001111
00000101010111
00000101011011
00000101011101
00000101100111
00000101101101
00000101110011
00000110001111
00000110011011
00000110100111
00000110101011
00001000101111
00001000111011
00001000111101
00001001001111
00001001010111
00001001011011
00001001011101
00001001100111
00001001101011
00001001110011
00001001110101
00001001111001
00001010001111
00001010011011
00001010011101
00001010101011
00001010101101
00001010110011
00001011000111
00001011001011
00001011001101
00001011010011
00001011100011
00001100010111
00001100101011
00001101000111
00010001001111
00010001010111
00010001011011
00010010001111
00010010010111
00010010011011
00010010011101
00010010101011
00010010101101
00010010110011
00010010110101
00010011000111
00010011001011
00010011001101
00010011010011
00010011010101
00010011100101
00010100010111
00010100011011
00010100100111
00010100101011
00010100101101
00010100110011
00010100110101
00010101001011
00010101001101
00010101010011
00010101010101
00010110001101
00010110010011
00010110100011
00011001010011
