0001101101111111
0001101111011111
0001110110111111
0010011110111111
0010101110111111
0010111001111111
0010111011101111
0010111101111011
0010111110110111
0010111111100111
0011010101111111
0011010110111111
0011011010111111
0011011110101111
0011011111010111
0011101101011111
