00000000000100010100010101
00000000000101000100010101
00000000010001000101000101
00000000010001010000010101
00000000010001010100000101
00000000010100010001000101
00000001000000010001010101
00000001000001000001010101
00000001000001000100010101
00000001000001010001000101
00000001000001010101000001
00000001000100000101000101
00000001000100000101010001
00000001000101000100000101
