0000111101110111111111111
0001011110111110111111111
0001011111110111111101111
0001101110111110111111111
0001101111101111110111111
0001101111110111110111111
0001101111111111101011111
0001110110110111111111111
0001110110111110111111111
0001110111011011111111111
0001110111111110110111111
0001110111111111011011111
0001111011011101111111111
0010101011111111101111111
0010101110111111011111111
0010101111100111111111111
0010101111110111110111111
0010101111110111111101111
0010101111110111111111011
0010101111111011111011111
0010101111111111110011111
0010110011111110111111111
0010110111011101111111111
0010110111111011101111111
0010111011011110111111111
0010111011100111111111111
0010111011101111011111111
0010111011101111111101111
0010111011101111111111101
0010111011110110111111111
0010111011110111101111111
0010111011110111110111111
0010111011111110111111101
0010111011111111101101111
0010111101011101111111111
0010111101011111111111011
0010111101110111110111111
0010111101110111111111011
0010111101111011111111011
0010111101111110111011111
0010111101111111011111011
0010111110011101111111111
0010111110011111111110111
0010111110101111111110111
0010111110111011111101111
0010111110111101110111111
0010111110111110111110111
0010111110111111011101111
0010111111011101111101111
0010111111011111101111011
0010111111110111110110111
0010111111111011101101111
0010111111111101110011111
0010111111111110101110111
0010111111111110101111011
0010111111111110111001111
0011001111010111111111111
0011001111101011111111111
0011010111011111101111111
0011010111011111110111111
0011010111101111101111111
0011010111110111111111011
0011010111111001111111111
0011010111111101111111011
0011010111111110110111111
0011010111111111010111111
0011010111111111101011111
0011011010111101111111111
0011011011010111111111111
0011011101011111111110111
0011011101111111110101111
0011011110101111101111111
0011011111010111101111111
0011011111011110101111111
0011011111110111101011111
0011011111110111111010111
0011011111111101101011111
0011011111111101110101111
0011011111111111010101111
0011101011011111110111111
0011101011111011011111111
0011101011111101101111111
0011101101011101111111111
0011101101111101011111111
0011110101110110111111111
0011110110101011111111111
0011110110111010111111111
0011111010101101111111111
0011111010110111011111111
0011111101101011101111111
