0000000110000010001000000100100000101010000001011
0000000100010000000100010000000100010010101010101
0000000100001000101001000001000000101001000100011
0000000100000011001000010010010001100000001010001
0000000010100001100100000011000010000010000100101
0000000010000001010010000110001001000011000100001
0000000010000000100000001000011110000000100001111
0000000001011000100100100000010010100000001000011
0000000001010001000001100001000001110001000000011
0000000001010000100010000110000101001000000100011
0000000001000110001100000000100001001000010100101
0000000001000000001000100001110010000101001000011
0000000000100000100110010100000001001001000001101
0000000000010000010000001000011010010010011010001
0000000000010000001011010000000000011000000110111
0000000000000011000000110000100010001001100010011
0000000000000011000000001010101100000000010101011
0000000000000010100010001000110100010001000100101
0000000000000001001001000001001000001011010011001
0000000000000000000000111000000000000110110110111
0000000000000000000000000101000101000101000111111
