0000000000000000000110100010001000100010111
0000000000000000000111000000100100100100111
0000000000000000010000110001010010010100011
0000000000000000100011000100100100100000111
0000000000000100000100000100000100000111111
0000000000000110000000000001100001010101011
0000000000000110000000000100100101010100011
0000000000001000001100001010001001001000101
0000000000001000010000100010001000101010011
0000000000001000100000000110000100101010011
0000000000001000100000010001000001101001011
0000000000001000100001000110010100001000011
0000000000001001000010000001010000100011101
0000000000001001001000000110001000110000101
0000000000001010000000001001110010001000101
0000000000010000000010111010101000010000001
0000000000010000000100001010001001001000111
0000000000010000100001000000001001011001101
0000000000010011000000001010000001100100101
0000000000100000000001000000000111010101011
0000000000100000010000000001101001011001001
0000000000100000111111000010000000000100001
0000000000100001000000010111010100000100001
0000000000100010000001010001100000011000101
0000000000100010010011000000000110000100101
0000000000100100000000100010001110000101001
0000000000100100001000010100000010000110101
0000000000101001000010000000010100010010011
0000000000110100010000000010100000010001011
0000000001000000100101100000100001000001101
0000000001000010000100000001100101010001001
0000000001000010001010100010001100000000011
0000000001000011000100110000010100000000101
0000000001001000001100001000011000001001001
0000000010000000100111001000000010000000111
0000000010000001000000100001000010001011101
0000000010000001000011010100000100000011001
0000000010000001001011100010000001000000011
0000000010000001011001000010000000010010011
0000000010000010000010001001110010000000101
0000000010001100000100101100000010000000101
0000000010100001001000000010100100000100011
0000000010110000010000000110000001000001101
0000000100000001000000010000000100011111001
0000000100000001000000110001000110000101001
0000000100000001001000001000100001000011101
0000000100000010000001000000100000010011111
0000000100000010000001000000100000100111101
0000000100000010000111000100000010000001011
0000000100000011000001001000100010010000011
0000000100000100000100000100000010000101111
0000000100000110000100000001000100000010111
0000000100000110000100000011100100000010001
0000000100001000010000100001001001001001001
0000000100001000100000010101000010000000111
0000000100001000100100100010000100001001001
0000000100001010100001000100010010000001001
0000000100010000001000001010100000100100011
0000000100010000010000010001001000010100101
0000000100011000100000001010000001000000111
0000000100100000100001000100000110100000011
0000000100100000100001001010000001000100011
0000000101000001000100001000010010000001011
