0000111011110111111101111111111111
0000111011111111011111110111111111
0000111101111011101111111111111111
0000111101111111111110111011111111
0001011101111111111101111011111111
0001011111110111011111111111101111
0001011111111011110111111111011111
0001011111111011111101111111110111
0001101101111111111111101011111111
0001101110111011111011111111111111
0001101111011111111110111110111111
0001101111110111111110111111101111
0001101111111011111011111101111111
0001101111111011111101111111110111
0001110011111111111111101101111111
0001110101111111111111011011111111
0001110101111111111111101101111111
0001110110111111011111101111111111
0001110110111111111011101111111111
0001110110111111111111100111111111
0001110110111111111111101011111111
0001110111011101101111111111111111
0001110111111101101111111110111111
0001110111111111011111101101111111
0001110111111111111011101101111111
0001111011011111110111011111111111
0001111011011111111101110111111111
0001111011101101111011111111111111
0001111011101111111011011111111111
0001111011111111111101110110111111
0001111101110101101111111111111111
0001111101110110101111111111111111
0010010111111111110111111110111111
0010011110111011111101111111111111
0010011111011111110111101111111111
0010101011111111101111111101111111
0010101011111111110111111110111111
0010101110111111101111110111111111
0010101111101111101111111111110111
0010101111101111110111111011111111
0010101111111011101111111111011111
0010101111111011111011111111110111
0010101111111111110111111011101111
0010110011111110111111110111111111
0010110011111111110111111110111111
0010110111011101110111111111111111
0010110111011111110110111111111111
0010110111011111110111101111111111
0010110111011111110111110111111111
0010110111101111110111111111111011
0010110111111011101111111011111111
0010110111111101110111111011111111
0010110111111101110111111110111111
0010110111111101110111111111011111
0010110111111111011111101111111011
0010110111111111101111111011110111
0010110111111111110111101110111111
0010110111111111111101110111011111
0010111001111110111111110111111111
0010111010111111111101111011111111
0010111011011111110111101111111111
0010111011101111111101111011111111
0010111011101111111101111111101111
0010111011110111101101111111111111
0010111011110111111101111011111111
0010111011110111111101111111110111
0010111011111011110111111110111111
0010111011111110111011110111111111
0010111011111111101111011101111111
0010111011111111110111011110111111
0010111011111111111101111001111111
0010111100111111111101110111111111
0010111101101111101111111111110111
0010111101110101110111111111111111
0010111101110111110110111111111111
0010111101110111110111011111111111
0010111101111011101011111111111111
0010111101111011101111101111111111
0010111101111011101111111111011111
0010111101111101110111101111111111
0010111101111101110111111011111111
0010111101111101110111111101111111
0010111101111111011101111101111111
0010111101111111110111011111111011
0010111101111111111010111011111111
0010111101111111111101110101111111
0010111101111111111101110111011111
0010111101111111111101110111101111
0010111110110111111101111111110111
0010111110111011110101111111111111
0010111110111011111101111011111111
0010111110111011111101111111101111
0010111110111101110111111011111111
0010111110111111011101111011111111
0010111110111111110101111111110111
0010111110111111111100111111110111
0010111110111111111101111011110111
0010111111001110111111111111011111
0010111111011101101111111111101111
0010111111011111101110111111101111
0010111111011111110111101111111011
0010111111011111110111110111110111
0010111111100111101111111111110111
0010111111101110011111111111011111
0010111111101110111111111111001111
0010111111101111011101111111011111
0010111111101111011111111111010111
0010111111101111011111111111011011
0010111111101111101111111011110111
0010111111110101111101111111110111
0010111111110111101110111110111111
0010111111110111111101110111110111
0010111111111011101111111111001111
0010111111111011111010111111110111
0010111111111011111101110111101111
0010111111111011111101111101111011
0010111111111011111101111111101011
0010111111111101110111111011101111
0010111111111101111101111101110111
0010111111111111101011111011110111
0010111111111111101101110111101111
0010111111111111110110101110111111
0010111111111111110110111011101111
0010111111111111110111100110111111
0010111111111111110111101011111011
0010111111111111110111101110111011
0010111111111111110111101111011011
0011010101111111110111111110111111
0011010111101111101111111101111111
0011010111110111110111111011111111
0011010111110111111110111111011111
0011010111111011111110110111111111
0011010111111101011111101111111111
0011010111111101110111111011111111
0011010111111101111111101111110111
0011010111111110101111111110111111
0011010111111111010111111110111111
0011010111111111100111111011111111
0011010111111111110111111010111111
0011011010111111101111101111111111
0011011010111111111111010111111111
0011011011111110101111111111101111
0011011101011111011110111111111111
0011011101011111110111101111111111
0011011101011111111111011110111111
0011011101111111010111111111101111
0011011101111111110101111111101111
0011011110101111101111101111111111
0011011110111110101111111110111111
0011011110111111111010111110111111
0011011111010110101111111111111111
0011011111010111101101111111111111
0011011111010111101111111111111011
0011011111011011111111111110101111
0011011111011110101111101111111111
0011011111011110101111111101111111
0011011111011110101111111110111111
0011011111011111010111101111111111
0011011111011111110111101011111111
0011011111011111111010111101111111
0011011111011111111101011110111111
0011011111101011110011111111111111
0011011111101111111110101111101111
0011011111110101111011111111101111
0011011111110101111111011111101111
0011011111110101111111111111001111
0011011111110111110101111011111111
0011011111110111110111101011111111
0011011111110111111010111111101111
0011011111110111111101011111101111
0011011111110111111110101111011111
0011011111111101101111111110101111
0011011111111110101111111110101111
0011011111111111011110111010111111
0011011111111111100111101011111111
0011011111111111101101111110101111
0011101010111111101101111111111111
0011101010111111111110110111111111
0011101011011111110011111111111111
0011101011111101111111011011111111
0011101011111110110111111110111111
0011101011111110110111111111110111
0011101011111111110111110110111111
0011101011111111111111011011110111
0011101101011111011111011111111111
0011101101011111111110111110111111
0011101101101111110101111111111111
0011101101111101111111010111111111
0011101101111101111111101011111111
0011101101111110101111111111011111
0011101101111111101011111111101111
0011101101111111110101111111101111
0011101101111111111111010111110111
0011101101111111111111101011101111
0011101111010110110111111111111111
0011101111010111111111111101101111
0011101111101011101101111111111111
0011101111111110101111111011011111
0011101111111110110111111110101111
0011101111111111011111011010111111
0011101111111111101101110101111111
0011101111111111110101110110111111
0011110101011111110110111111111111
0011110101011111111111101101111111
0011110101110111110110111111111111
0011110101110111111111011011111111
0011110101110111111111111011011111
0011110101111111111111011011101111
0011110110111011111111101011111111
0011110110111011111111110101111111
0011110110111111111111101010111111
0011110111010111111111110110111111
0011110111101101110101111111111111
0011110111111101011011101111111111
0011110111111101011101101111111111
0011110111111111110101110110111111
0011111011010111111111101110111111
0011111011110110101110111111111111
0011111011111110111010110111111111
0011111011111110111011010111111111
0011111011111111101110101101111111
0011111011111111110111010110111111
0011111011111111110111011010111111
0011111101101010101111111111111111
0011111101101011101101111111111111
0011111101101011101111111110111111
0011111101101110101111011111111111
0011111101110101101111111110111111
0011111101110111010110111111111111
0011111101110111110110101111111111
0011111101111101110101101111111111
0011111101111101110110101111111111
0011111110101010110111111111111111
0011111111010101101101111111111111
0011111111010110110111011111111111
0011111111011010101110111111111111
0011111111011010101111101111111111
0011111111011011110101110111111111
0011111111011110110111010111111111
0011111111011111010101101111111111
