0000000101000101010101
0000010001000101010101
0000010001010100010101
0000010001010101000101
0000010100010001010101
