000000001000000001000000001000000001000011011011
000000000000000011000000000000011001001001001011
000000000000010001000000000000011001001001001011
000000000000001010000000000000011001001001001011
000000000000010001000000000010001001001001001011
000000000000001000001000001010000001010001001011
000000000000001001010000000001001000001010001011
000000000001001000010000000001001000001010001011
000000000000001001010001000001001000000010001011
000000000001001000011000001001000000000010001011
000000000000001001010000010001001000001000001011
000000000001001000010000010001001000001000001011
000000000000001001010001010001001000000000001011
000000001000000001000000001000000001001011010011
000000000000010010001000000010010000010001010011
000000000010010000001000000010010000010001010011
000000000000010010001010000010010000000001010011
000000001000000001000000001000001001001010010011
000000000000010000010000010001000010001010010011
000000001000010000010000010000000010001010010011
000000001000000001000000001001001000001010010011
000000001000000001000001001001000000001010010011
000000001000000001001001000001000000001010010011
000000000000000011000000000000011010010010010011
000000000000001010000000000001010010010010010011
000000000000010010001000001010010000010000010011
000000000010010000001000001010010000010000010011
000000000000010010001010001010010000000000010011
000000001000001000001000000010000001011001000011
000000000000001001001000001010000001010001000011
000000001000001001001000000010000001010001000011
000000000000010010010000010001000010001010000011
000000001000010010010000010000000010001010000011
000000000000010001001001001001011000000000000011
000000000000001010010010010010011000000000000011
000000000000010001001001001011001000000000000011
000000000000001010010010010011010000000000000011
000000001000000001000000001000000001000101101101
000000000000000101000000000000101001001001001101
000000000000100001000000000000101001001001001101
000000000000100001000000000100001001001001001101
000000000000001000001000001100000001100001001101
000000000000001001100000000001001000001100001101
000000000001001000100000000001001000001100001101
000000000000001001100001000001001000000100001101
000000000001001000101000001001000000000100001101
000000000000001001100000100001001000001000001101
000000000001001000100000100001001000001000001101
000000000000001001100001100001001000000000001101
000000001000000001000000001000000001001101100101
000000000000100100001000000100100000100001100101
000000000100100000001000000100100000100001100101
000000000000100100001100000100100000000001100101
000000001000000001000000001000001001001100100101
000000000000100000100000100001000100001100100101
000000001000000001000000001001001000001100100101
000000001000000001000001001001000000001100100101
000000001000000001001001000001000000001100100101
000000000000000101000000000000101100100100100101
000000000000100100001000001100100000100000100101
000000000100100000001000001100100000100000100101
000000000000100100001100001100100000000000100101
000000001000001000001000000100000001101001000101
000000000000001001001000001100000001100001000101
000000001000001001001000000100000001100001000101
000000000000100100100000100001000100001100000101
000000000000100001001001001001101000000000000101
000000000000100001001001001101001000000000000101
000000000000010001000000000010001001001001011001
000000000010000001000000000010001001001001011001
000000000010000001000000010000001001001001011001
000000000000001000001000011000000011000001011001
000000000001001010000010000001001000001000011001
000000000001001010001000001001000000010000011001
000000000000100001000000000100001001001001101001
000000000100000001000000000100001001001001101001
000000000100000001000000100000001001001001101001
000000000000001000001000101000000101000001101001
000000000010000001000000010000001001001011001001
000000001000000001000000001000000011010011001001
000000000000001000001010001000010001000011001001
000000000100000001000000100000001001001101001001
000000001000000001000000001000000101100101001001
000000000000001000001100001000100001000101001001
000000000000000001001001000001001001001001001001
000000000000001000001001000001001001001001001001
000000000001000000001001000001001001001001001001
000000000000001001000001000001001001001001001001
000000000001000001000001000001001001001001001001
000000001000000001000001000001001001001001001001
000000000001001000000001000001001001001001001001
000000001000001000000001000001001001001001001001
000000000000001001001000000001001001001001001001
000000000001000001001000000001001001001001001001
000000001000000001001000000001001001001001001001
000000000001001000001000000001001001001001001001
000000001000001000001000000001001001001001001001
000000000000000001001001001000001001001001001001
000000000000001000001001001000001001001001001001
000000000000001001000001001000001001001001001001
000000000001000001000001001000001001001001001001
000000001000000001000001001000001001001001001001
000000000001001000000001001000001001001001001001
000000001000001000000001001000001001001001001001
000000000000001001001000001000001001001001001001
000000000001000001001000001000001001001001001001
000000001000000001001000001000001001001001001001
000000000001001000001000001000001001001001001001
000000001000001000001000001000001001001001001001
000000000001001001000000001000001001001001001001
000000001000001001000000001000001001001001001001
000000000001000001001001000000001001001001001001
000000001000000001001001000000001001001001001001
000000000001001000001001000000001001001001001001
000000001000001000001001000000001001001001001001
000000000001001001000001000000001001001001001001
000000000000001000001001001001000001001001001001
000000000001000000001001001001000001001001001001
000000000000001001000001001001000001001001001001
000000000001000001000001001001000001001001001001
000000000001001000000001001001000001001001001001
000000000000001001001000001001000001001001001001
000000000001000001001000001001000001001001001001
000000000001001000001000001001000001001001001001
000000000001001001000000001001000001001001001001
000000001000000001001001000001000001001001001001
000000000001001000001001000001000001001001001001
000000001000001000001001000001000001001001001001
000000001001000000001001000001000001001001001001
000000001000001001000001000001000001001001001001
000000001001000001000001000001000001001001001001
000000001000001001001000000001000001001001001001
000000000001000001001001001000000001001001001001
000000001000000001001001001000000001001001001001
000000000001001000001001001000000001001001001001
000000001000001000001001001000000001001001001001
000000000001001001000001001000000001001001001001
000000001000001001000001001000000001001001001001
000000001001000001000001001000000001001001001001
000000000000001000001001001001001000001001001001
000000000000001001000001001001001000001001001001
000000001000000001000001001001001000001001001001
000000000000001001001000001001001000001001001001
000000001000000001001000001001001000001001001001
000000001000001000001000001001001000001001001001
000000001000001001000000001001001000001001001001
000000000001000001001001000001001000001001001001
000000001000000001001001000001001000001001001001
000000000001001000001001000001001000001001001001
000000001000001000001001000001001000001001001001
000000000001001001000001000001001000001001001001
000000001001000001000001000001001000001001001001
000000000001001001001000000001001000001001001001
000000001000001001001000000001001000001001001001
000000000001000001001001001000001000001001001001
000000001000000001001001001000001000001001001001
000000000001001000001001001000001000001001001001
000000001000001000001001001000001000001001001001
000000001001000000001001001000001000001001001001
000000000001001001000001001000001000001001001001
000000001001000001000001001000001000001001001001
000000001000001001001000001000001000001001001001
000000001001000001001000001000001000001001001001
000000000001000001001001001001000000001001001001
000000000001001000001001001001000000001001001001
000000001000001000001001001001000000001001001001
000000001000001001000001001001000000001001001001
000000001000001001001000001001000000001001001001
000000001000000001000000001000010011010001001001
000000000000001000011000001010000001010001001001
000000001000000001000000001000100101100001001001
000000000000001000101000001100000001100001001001
000000000001000000001001001001001001000001001001
000000001000000001000001001001001001000001001001
000000000001000001001000001001001001000001001001
000000001000000001001000001001001001000001001001
000000000001000001001001000001001001000001001001
000000000001001000001001000001001001000001001001
000000001000001001000001000001001001000001001001
000000001001000001000001000001001001000001001001
000000001000001001001000000001001001000001001001
000000000001000001001001001000001001000001001001
000000000001001000001001001000001001000001001001
000000001000001000001001001000001001000001001001
000000000001001001000001001000001001000001001001
000000001000001001000001001000001001000001001001
000000001001000001000001001000001001000001001001
000000001000001001001000001000001001000001001001
000000001001000001001000001000001001000001001001
000000001001001000001000001000001001000001001001
000000001000001001001001000000001001000001001001
000000001000000001000000011010010001000001001001
000000001000000001000000101100100001000001001001
000000000001000001001001001001000001000001001001
000000000001001000001001001001000001000001001001
000000001001000001000001001001000001000001001001
000000001001000001001000001001000001000001001001
000000001000001001001001000001000001000001001001
000000001001000001001001000001000001000001001001
000000001000000001000010011010000001000001001001
000000000010001000011000001010000001000001001001
000000001000000001000100101100000001000001001001
000000000100001000101000001100000001000001001001
000000001000000011010010001000000001000001001001
000000001000000101100100001000000001000001001001
000000000001000001001001001001001000000001001001
000000001000001000001001001001001000000001001001
000000001000001001000001001001001000000001001001
000000001001000001000001001001001000000001001001
000000001000001001001000001001001000000001001001
000000001000001001001001000001001000000001001001
000000001000001001001001001000001000000001001001
000000000001001000000001001001001001001000001001
000000000001001000001000001001001001001000001001
000000001000001000001000001001001001001000001001
000000000001000001001001000001001001001000001001
000000000001001000001001000001001001001000001001
000000001000001000001001000001001001001000001001
000000001000001001000001000001001001001000001001
000000001001000001000001000001001001001000001001
000000001000001001001000000001001001001000001001
000000001000001000001001001000001001001000001001
000000001000001001000001001000001001001000001001
000000001001000001000001001000001001001000001001
000000001001000001001000001000001001001000001001
000000001000001001001001000000001001001000001001
000000000001000001001001001001000001001000001001
000000001000001000001001001001000001001000001001
000000001000001001001001000001000001001000001001
000000001000001001000001001001001000001000001001
000000001000001001001000001001001000001000001001
000000001000001001001001000001001000001000001001
000000001000001001001001001000001000001000001001
000000000010001001000001000001011000010000001001
000000000010001011000001000001001000010000001001
000000000100001001000001000001101000100000001001
000000000100001101000001000001001000100000001001
000000000001000001001001001001001001000000001001
000000001000001000001001001001001001000000001001
000000001000001001001001000001001001000000001001
000000001000001001001001001000001001000000001001
000000001000000001000000001000001001011010010001
000000000010000010000010000001010000011010010001
000000001000000001000001001001000000011010010001
000000000000010001000000000010011010010010010001
000000000010000001001001001011001000000000010001
000000000010000001001001011001001000000000010001
000000001000001000001000100000000101001001100001
000000001000001001001000100000000101000001100001
000000001000000001000000001000001001101100100001
000000000100000100000100000001100000101100100001
000000001000000001000001001001000000101100100001
000000000000100001000000000100101100100100100001
000000000100000001001001001101001000000000100001
000000000100000001001001101001001000000000100001
000000001000000001000000001000000011011011000001
000000001000001000001010000000010001001011000001
000000001000001001001010000000010001000011000001
000000001000000001000000001000000101101101000001
000000001000001000001100000000100001001101000001
000000001000001001001100000000100001000101000001
000000001000001000011000000010000001011001000001
000000001000001000101000000100000001101001000001
000000001000001001000000001001001001001001000001
000000001000001000001001000001001001001001000001
000000001000001001001000000001001001001001000001
000000000001000001001001001000001001001001000001
000000001000001000001001001000001001001001000001
000000001000001001001000001000001001001001000001
000000001000000001000000011010010001001001000001
000000001000000001000000101100100001001001000001
000000001000001001000001001001000001001001000001
000000001000000011010010001000000001001001000001
000000001000000101100100001000000001001001000001
000000001000001000001001001001001000001001000001
000000000010000001000000010010011010010010000001
000000000100000001000000100100101100100100000001
