0000000010111
0000000100111
0000001001101
0000010000111
0000010010011
0000010010101
0000010100011
0000100001011
0000100010011
0000100010101
0000100011001
0000100100101
