0000000010111001011
0000000101101100011
0000000110010101011
0000001000011011101
0000001000101100111
0000001001001010111
0000001001011100011
0000001010001011011
0000001010010110011
0000001011001100011
0000010001001101011
0000010001110010101
0000010010100110011
0000010011100001101
0000010011101000011
0000010100001001111
0000010100110001011
0000010101100010011
0000100001000101111
0000100010001001111
0000100010100100111
0000100011101000101
0000100011101001001
0000100100010111001
0000100100100010111
0000100101100010101
0000101000100101011
