00000000010000000011
00000000010000000101
00000000010000001001
00000000010000010001
00000000010000100001
