00101111011111111011111111110111011111011111111111
00101111011111111111111111011110111110111011111111
00101111101111011111111101111111110111111111110111
00101111111011101111111111011110111111111111011111
00110111101111101111110101111111110111111111111111
00110111111111100111101011111111111111111011111111
00111010111101101111111110111111110111111111111111
00111011111111111111011111101101111101011111111111
00111011111111111111111101111101101111010111111111
00111110111011111111111111111111101101011011111111
