00001110111011111111111
00001110111111101111111
00001111011101111111111
00010101111111110111111
00010110111111101111111
00010111011110111111111
00010111101111101111111
00010111111011111110111
00010111111101111101111
00010111111111101101111
00011001111111110111111
00011011011011111111111
00011011011111011111111
00011011101011111111111
00011011110111110111111
00011011110111111011111
00011011111011110111111
00011011111011111011111
00011011111111011011111
00011011111111101011111
00011011111111110101111
00011101011011111111111
00011101101011111111111
00011101101101111111111
00011101101110111111111
00011101101111011111111
00011101110110111111111
00011101111110110111111
00011101111111011011111
00011101111111101101111
00011110011011111111111
00011110110011111111111
00011110110111011111111
00100111011111011111111
00100111101011111111111
00100111101111110111111
00100111110111101111111
00101010111111101111111
00101010111111110111111
00101011011111011111111
00101011101111110111111
00101011110011111111111
00101011110111110111111
00101011111001111111111
00101011111011111011111
00101011111011111110111
00101011111101111101111
00101011111110111011111
00101011111110111110111
00101011111111101011111
00101011111111101111101
00101011111111110011111
00101011111111111001111
00101100111111011111111
00101101101110111111111
00101101110011111111111
00101101110111011111111
00101101110111101111111
00101101110111111101111
00101101110111111111101
00101101111101110111111
00101101111111011110111
00101101111111101110111
00101110011111011111111
00101110101111011111111
00101110101111111110111
00101110110111101111111
00101110110111111101111
00101110111001111111111
00101110111011110111111
00101110111011111111101
00101110111101110111111
00101110111101111111011
00101110111110111111101
00101110111111011101111
00101110111111101111011
00101110111111110101111
00101110111111110110111
00101110111111111001111
00101111001110111111111
00101111001111111110111
00101111010111011111111
00101111010111111111011
00101111011011111111011
00101111011101011111111
00101111011101111101111
00101111011110111011111
00101111011111011101111
00101111011111011110111
00101111011111011111011
00101111100111011111111
00101111101011111110111
00101111101101111110111
00101111101110111110111
00101111101111011110111
00101111101111101110111
00101111101111111110011
00101111110111011101111
00101111110111101111011
00101111111011011101111
00101111111011101101111
00101111111011110111011
00101111111011111010111
00101111111011111101011
00101111111011111110011
00101111111101110011111
00101111111101110101111
00101111111110101110111
00101111111110101111011
00101111111110111001111
00101111111111010101111
00101111111111011001111
00101111111111011100111
00101111111111100111011
00110011101011111111111
00110011110101111111111
00110011111010111111111
00110101011110111111111
00110101011111111011111
00110101011111111101111
00110101101011111111111
00110101101110111111111
00110101101111110111111
00110101101111111011111
00110101110111110111111
00110101111011011111111
00110101111011101111111
00110101111100111111111
00110101111110011111111
00110101111110101111111
00110101111110110111111
00110101111110111110111
00110101111111010111111
00110101111111011011111
00110101111111100111111
00110101111111101011111
00110101111111110101111
00110101111111110111011
00110110101011111111111
00110110101110111111111
00110110101111111110111
00110110101111111111011
00110110110101111111111
00110110111101011111111
00110111010110111111111
00110111010111101111111
00110111010111111110111
00110111011111110101111
00110111011111111010111
00110111101011101111111
00110111101011111011111
00110111101011111101111
00110111101111101011111
00110111110101111011111
00110111110101111110111
00110111110111101011111
00110111110111110101111
00110111111010111110111
00110111111011110101111
00110111111101011011111
00110111111101101011111
00110111111110110101111
00110111111110111010111
00110111111111010101111
00110111111111101010111
00111010110110111111111
00111010110111110111111
00111010110111111101111
00111010111101101111111
00111010111110110111111
00111010111111101101111
00111011010111110111111
00111011010111111011111
00111011011101011111111
00111011011111010111111
00111011011111101011111
00111011111011010111111
00111011111101101011111
00111101010110111111111
00111101011011101111111
00111101101010111111111
00111101101110101111111
00111101110110101111111
00111110101011011111111
00111110110101110111111
00111110111010110111111
00111110111011010111111
