000110111111101111111101111
000111011011111101111111111
000111011101101111111111111
000111011111111110110111111
001010111110111111011111111
001010111111101111111011111
001010111111110111110111111
001011101110111101111111111
001011101111011111110111111
001011110111011111111101111
001011110111110111011111111
001011110111111110111110111
001011111010111111111110111
001011111101110111111101111
001011111111101111101110111
001011111111111101110011111
001100111110101111111111111
001101011110111111101111111
001101011111111111010111111
001101110101111011111111111
001101111010111011111111111
001101111101011110111111111
001110101111111011011111111
001111010110111011111111111
001111011010101111111111111
001111110110101110111111111
001111110111010110111111111
