000000000000010101101001100011101
000000000001000101101011001000111
000000000001001001010110001010111
000000000001001101000010111000111
000000000001010101101100011000011
000000000001010110001010110000111
000000000001011001001011001001011
000000000001100010010011010100111
000000000010010011100000011101011
000000000010011010010011010010011
000000000010011100011010001001101
000000000011001001001011001001011
000000000011001001011001001001011
000000000100000100110001101010111
000000000100001110010100110110001
000000000100010011010000011010111
000000000100010101001000011111001
000000000100011001010110001010011
000000000100100001011001010111001
000000000100101011110000010010011
000000000100101100100101100100101
000000000101001001001101001001101
000000000101001001101001001001101
000000000101001100001011010001101
000000000101100001000101101010011
000000000101100011010010100010011
000000000110000100100010110001111
000000000110000111010001001010011
000000000110001001101000101001011
000000000110001010100001001011011
000000001000010010101001100001111
000000001000011110000101011001001
000000001000101000110001001011011
000000001000111000101100100001011
000000001001000011100000110011101
000000001001001001010001011001011
000000001001001001100001101001101
000000001001001011000011001011001
000000001001001101000101001101001
000000001001010111000110000010011
000000001001100011000011010001101
000000001001101010100100110000101
000000001001110001010011000001101
000000001010001001011000010110011
000000001010001110101001000100101
000000001010010010010011010010011
000000001010010010011010010010011
000000001010010011010010010010011
000000001010110010010001101000011
000000001011000000100010011010111
000000001011001001000011001001011
000000001011001001010001001001011
000000001101000001000100011010111
000000010000001011000101000111011
000000010000001111001100010101001
000000010000011010010100011001101
000000010000101010001101101100001
000000010000111001000001111010001
000000010000111010100001011010001
000000010001000101000010001101111
000000010001001001001011001001011
000000010001001001011001001001011
000000010001001001011001001011001
000000010001001011001001001001011
000000010001001011001001001011001
000000010001001011001001011001001
000000010001010000001101111000011
000000010001010010110010000111001
000000010001010011001110000101001
000000010001100000010101001101101
000000010001110110000010110001001
000000010010010001110011010000101
000000010010010010001010011010011
000000010010010010001101010100011
000000010010100110011000001000111
000000010011000111010010001000101
000000010011010010000011010010011
000000010011010010001010010010011
000000010011101000101001000001101
000000010100000100010100110011101
000000010100001000001100100111101
000000010100001110100010001100101
000000010100010100111001000100101
000000010100011001001100001001011
000000010100011100010100100010011
000000011000001010001000010110111
000000011001001001010001001001011
000000100000110011000010101100101
000000100000111010000110010110001
000000100000111101010001100001001
000000100001000100101100001010111
000000100001001001001101001001101
000000100001001001101001001001101
000000100001001001101001001101001
000000100001001100001000111010011
000000100001001101001001001001101
000000100001001101001001001101001
000000100001001101001001101001001
000000100001011000000110101100101
000000100001011000111010000011001
000000100001100010010111100000101
000000100010000110010000100101111
000000100010000110110000101010011
000000100010001100001011011010001
000000100010110000010011100100101
000000100100000101000110000110111
000000100100001100100000101110011
000000100100011001000001111000101
000000100100011100011000000110101
000000100100100100001100101100101
000000100100110001000010100001111
000000100101000100001110100011001
000000100101010000010110000110011
000000100101100100000101100100101
000000100101100100001100100100101
000000101000010000010010100111011
000000101000100010010110100100011
000000101001000110000010001011101
000000101001001001100001001001101
000001000001000110011001010000111
000001000001010001000110100101011
000001000001010001001001001011011
000001000001010001001011001001011
000001000001010011001001001001011
000001000001011001001001001010011
000001000001011001001011001000011
000001000001011011001001001000011
000001000011000001001001011011001
000001000011000001011001001011001
000001000011001001001001011010001
000001000011001001011001001010001
000001000011010001001001001011001
000001000011011001001001001010001
000001000100000101100101000010111
000001000100001001010000011110011
000001000100001001101101010000011
000001000100011101100000110001001
000001000100100011100001011010001
000001000100100011110100000100101
000001000101000001001001101101001
000001000101000001101001001101001
000001000101100001001001001101001
000001000101100110000100100001011
000001000101110010000101100001001
000001000110010111000001001000101
000001001000001001000001011011011
000001001000001001000011011011001
000001001000001001000101101101001
000001001000001001001000011011011
000001001000001001001000101101101
000001001000001001001001010011011
000001001000001001001001100101101
000001001000001001001010011011001
000001001000001001001011010011001
000001001000001001001100101101001
000001001000001001001101100101001
000001001000001001010001011001011
000001001000001001011001010001011
000001001000001001100001101001101
000001001000001001101001100001101
000001001000010111001010001000101
000001001000011001001000001011011
000001001000011001010001011001001
000001001000011001011001010001001
000001001000011011001000001001011
000001001000011011010001001001001
000001001000011011011000001001001
000001001000101001001000001101101
000001001000101001100001101001001
000001001000101101001000001001101
000001001000101101100001001001001
000001001000101101101000001001001
000001001001000001001001010011011
000001001001000001001001100101101
000001001001000001001010011011001
000001001001000001001011010011001
000001001001000011011010001001001
000001001001001000001001010011011
000001001001001000001001100101101
000001001001001000010001011001011
000001001001001000011001010001011
000001001001001000100001101001101
000001001001001000101001100001101
000001001001001010000011001011001
000001001001001010001011000011001
000001001001001100000101001101001
000001001001001100001101000101001
000001001001010001001001000011011
000001001001010011001000001001011
000001001001010011001001000001011
000001001001011000010001011001001
000001001001011001001000001010011
000001001001011001001010001000011
000001001001100001001001000101101
000001001001100101001000001001101
000001001001101000001010100100011
000001001001101001001100001000101
000001001010001001001000011011001
000001001011001000010001001001011
000001001011010001001001000011001
000001001011011000001100010000101
000001001101001000100001001001101
000001010000100100010001001011101
000001010001000011001001001001011
000001010001001001001011001000011
000001010001001011001001001000011
000001010010010001000010000101111
000001010011101000100001000010011
000001010100001100110000100100011
000001011001001000010001001001011
000001011001001001001010001000011
