000001001110101111
000001011010111011
000001100110101111
000010001101011111
000010011001011111
000010011011101011
000010011101001111
000010011110011101
000010101011011011
000010101101100111
000010101111001101
000010110001111011
000010111001011011
000011000101011111
000011001010011111
000011001010101111
000011010001110111
000011010101011011
000011011001010111
000100011010011111
000100011011001111
000100100101110111
000100101001101111
000100101011001111
000100101111100011
000100110100111101
000100110111100011
000100111001101101
000100111100110101
000100111101001101
000101000101101111
000101001011011101
000101001100111101
000101001101100111
000101001110011011
000101001110011101
000101001111100101
000101010011001111
000101011010011011
000101011101001011
000101100011101101
000101100101001111
000101100111001101
000101101001100111
000101101101000111
000101110100100111
000110101001001111
000111001001010111
