00101111111011101111011111111011111101111101111111111111111111111
00111011011111011111111111101111111111011111111101011111111111111
00111010111111011111111111111111011111111101111111011011111111111
00111011111101011111110111111111111111111111111011011011111111111
00011101110111111111111111110111111011111111111111101101111111111
00111101111111111101101110111111111111111111011111111110101111111
00101011111111011111111111101111101111111111111111011111110111111
00111011111111111110111111101011111111111111111111011011111011111
