00000000010000000001000000001100011
00000000000000000011000010000100011
00000000000001000001000010000100011
00000000000000100001000100000100011
00000000010000100000000100000100011
00000000010000000001000010001000011
00000000000001000010000010001000011
00000000010000100000000010001000011
00000000000000100010000100001000011
00000000010000000001000000010100101
00000000000000000101000010000100101
00000000000010000001000010000100101
00000000000000100001001000000100101
00000000010000100000001000000100101
00000000010000000001000010010000101
00000000000010000100000010010000101
00000000010000100000000010010000101
00000000000000100100001000010000101
00000000010000000001000000100101001
00000000000000001001000010000101001
00000000000100000001000010000101001
00000000000000100001010000000101001
00000000010000100000010000000101001
00000000010000000001000010100001001
00000000000100001000000010100001001
00000000010000000001000001000110001
00000000000000010001000010000110001
00000000001000000001000010000110001
00000000000000100001100000000110001
00000000010000100000100000000110001
00000000010000000001000011000010001
00000000001000010000000011000010001
00000000000001000001000010001100001
00000000010000100010000000001100001
00000000000010000001000010010100001
00000000010000100100000000010100001
00000000000100000001000010100100001
00000000001000000001000011000100001
00000000010000100001000010000100001
00000000010000000011000100000100001
00000000010000000101001000000100001
00000000010000001001010000000100001
00000000010000010001100000000100001
