0000000100010101010101010001010101
0000000101000101000101010101010101
0000000101000101010101000101010101
0000000101010001010001010101010101
0000010001000101010101000101010101
0000010001000101010101010001010101
0000010001010001010100010101010101
0000010001010100000101010101010101
0000010001010100010101010001010101
0000010001010100010101010101010001
0000010001010101000101010001010101
0000010001010101000101010101000101
0000010001010101010001010100010101
0000010001010101010101000100010101
0000010001010101010101010000010101
0000010100010001000101010101010101
0000010100010001010100010101010101
0000010100010001010101010100010101
0000010100010001010101010101000101
0000010100010100010001010101010101
0000010100010101010001000101010101
0000010100010101010100010001010101
0000010100010101010101000100010101
0000010101000100010100010101010101
