0010111111011111111010111011111110111101111111111111111111111111
0011110111011011111111111111111011111111110111110101111111111111
0011111011101111111111111111111111011111111011011010111111111111
0001111011101111111111111111111011111110111111111011011111111111
0010111101111111110111111111111111011111011101111111101111111111
0011111101110101111111111110110101111111111111111111111011111111
0011111011111111111111111111101110111111101101011111111011111111
0011011111111111111010111101111101111111110111111111111101111111
0011110111111111111111110111111111110110111011111111110101111111
0011101111111111111111111011111111110110110111111111111010111111
0011011110111111111111111111111010111111111110101111111111011111
0011101111111111110111111110110111111111111111110101111111011111
0011011111010111111111111111111011110111111111111110111111011111
0011101111101011111101111111111111011011111111111111111111101111
0001101111111101011111111111111111011111110111111111111111101111
0011011111110101111111111111110111111011111101111111111111101111
