0000000001000110110110101100011111
0000000010011011100000101111010111
0000000010101110011000011111001101
0000000010111011100000101110010111
0000000100100111100011110001001111
0000000100110101100010011011111001
0000000100110101110010001001101111
0000000100110111110010001001101011
0000001000100011010110010111101011
0000001000100101011010011001111011
0000001000111100011110010001111001
0000001000111100100010110101101011
0000001000111100100011110001111001
0000001001001111000100110011010111
0000001001010111001010010010111011
0000001001011001100111010100001111
0000001001011101000100011011110011
0000001001101011000100010011011111
0000001001101111000100010011010111
0000001100110111110010001001001011
0000001101000111110001010010101011
0000010000101111110100100001110101
0000010001010110001010100110111101
0000010001101010011000111001011011
0000010001110010010010111001010111
0000010010001001110100011101101011
0000010010001011110000101101010111
0000010010011110000110011110010101
0000010010100110111100110000011011
0000010010101001110010101100010111
0000010010101011110000101100010111
0000010010111100100110100001110101
0000010011001000110010111100101011
0000010011100110110100011000011101
0000010011110001001000110101101011
0000010011110001011000100111100011
0000010100110111101010001000101011
0000010100111110100010101100010011
0000010101010000100010010111101111
0000010110001001110010100101010111
0000010110001011110000100101010111
0000010110100001100110100111000111
0000010110100001100110101101100011
0000010110101011110000100100010111
0000010110110001100110101101000011
0000011000101000010101111001011011
0000011001000101001011110010110011
0000011010101011000010100100011111
0000011101100011000010001001101111
0000100001000110110001100011011111
0000100001001011100011000111011101
0000100001001101100101001111010011
0000100001001110100011000110011111
0000100001001111100011000110011101
0000100001010111001001000011111011
0000100001100100111001010011011011
0000100010001110100001011010011111
0000100010001111000010101101101101
0000100010001111100001011010011101
0000100010010001000110111110101011
0000100010110011101100001011010101
0000100010111010101001110100110001
0000100010111110000110011100001101
0000100011001001100101010111010011
0000100011001010100011000011011111
0000100011001110100011000010011111
0000100011001111100011000010011101
0000100011101001100101010110010011
0000100011101011101001100100010011
0000100011111100100011000010110011
0000100100101010100001001011111101
0000100100101110100001001011110101
0000100100101111110100001001010101
0000100100111010100001001011011101
0000100100111110100001001011010101
0000100101000110111000101000011111
0000100101100010100011011001011101
0000100101100110100011011001010101
0000100111100001011001001111000101
0000100111100010010001001111000111
0000100111100011010001001111000101
0000101000100011101001011001010111
0000101000101011101001011001000111
0000101000101111101001001001000111
0000101000111011100010011001000111
0000101001000111100110100010001111
0000101010101001111001001101000011
0000101011001000100101000111010111
0000101011001001100101000111010011
0000101011101001100101000110010011
0000101100100011101001010001010111
0000101100101011101001010001000111
0000101100111011100010010001000111
0000101101001001100011011010100011
0000101101001001100110011010100011
0000101101010001100011011010010011
0000101101010001100110011010010011
0000101101010001110001110010010011
0000101110100011100101010001001011
0000110001101101101001000100101011
0000110010101100010001101001011011
0000110011101001101001000100010111
0000110100101100010001100101011011
0000111000100100011010010001011111
