00011011101111101111111111
00011011111101111101111111
00011101110110111111111111
00011101111111110110111111
00100111101111110111111111
00101011111110111111011111
00101011111111011111101111
00101101110111011111111111
00101101111111101110111111
00101110111110111101111111
00101110111111110111101111
00101111010111011111111111
00101111011111011101111111
00101111011111110111011111
00101111100111011111111111
00101111101101111111110111
00101111110111011111101111
00101111110111101111111011
00101111111111011011101111
00101111111111011110111011
00110011111010111111111111
00110101111111011111101111
00110111110101111011111111
00110111111010111111101111
00110111111101011111101111
00110111111111011110101111
00111010111110110111111111
00111010111111101101111111
00111010111111111101101111
00111011011111010111111111
00111011011111111101011111
00111011111111101101011111
00111101101010111111111111
00111110101011011111111111
00111111011010111011111111
00111111011101011011111111
