00000000011010100110100100111010011101111
00000000100111001011001010111001011110011
00000000101011001011001110010111001010111
00000000110010110001110010101101100111011
00000000110010110001111010001101100111011
00000001000101011110001011110001101001111
00000001001010100011111001010011001101111
00000001001110101001110100111001101001101
00000001010001111110011110010100001011011
00000001010010010110011100101110010101111
00000001011001010100001001110111010011111
00000001011100111001011100100101100101011
00000001011101100100100101011100111001011
00000001100011011011101100010110000110111
00000001100110000010101010010110111110111
00000010000011001101111001001110111010101
00000010000101110101101100001110111100101
00000010000111001101111001001100111010101
00000010000111101110000111111000111010001
00000010001001100011111100001110111100101
00000010001011000111111100001100111101001
00000010001011011100001101010011110110011
00000010001011100011011100001110111101001
00000010001011101110010011010110011001011
00000010001100111010111011011000010110101
00000010010010110010111001000101111100111
00000010010100100111110100011010111010101
00000010010101001101111110001100111000101
00000010010101011000011010111110100110011
00000010010101100101111100000110111010101
00000010010101100111111100000010111010101
00000010010101100111111100010010110010101
00000010010101110001000011101101100101111
00000010010101110001010001101101100101111
00000010010101110001100011001101100101111
00000010011000011000111100101111101100101
00000010011000110010110111010001010101111
00000010011000110110110111010000010101111
00000010011010011100110100001110100111101
00000010011011001010101111000011101100011
00000010011100101100000101010111001111011
00000010011100101100000101110111001111001
00000010011100101110000101110101001111001
00000010100001110101111001010110011001101
00000010100100001010111011000111110011011
00000010100100101011101101010000111011011
00000010100100101111101101010000110011011
00000010100100101111101101110000100011011
00000010100100111110011001101010001011011
00000010100100111110011100101010001011011
00000010100110010111111010000100110101011
00000010100110111100100111100011000011101
00000010100111110100011100110110011000011
00000010101011101110010010110110011000011
00000010101100001110001011010011001111101
00000010101100010010110100010111011100111
00000010110011001001001010111001110010111
00000010110100001100100111110111000101011
00000010110100111100100101010111000110011
00000010110101010001111001111011001000011
00000010110101010001111101111001001000011
00000010110110111000100101010111000110011
00000010111001110010111001001001001010111
00000011000010101101111011100010010011011
00000011000110011101011101101000001011011
00000011000110111000011100101010011011011
00000011010100000110001101111010101011011
00000011010100011001001100001010111011111
00000011010101000100001011111101001100111
00000011010101001000001011111110110000111
00000011010101001000101011111010110000111
00000011101010100001001011001111000110111
00000100000101010011100011011100011111011
00000100001010111011000110001111100110101
00000100010001101110001010101111001011011
00000100010001110110101101111000011001011
00000100010001111001011000111101000111101
00000100010011001111011000001111101001011
00000100010011001111011010001111100001011
00000100010111001011000110011111000011101
00000100011000011100100111000101111110101
00000100011010100011101110000011101011011
00000100011100110110001111100010101101001
00000100011111001010011001101111000001011
00000100100001100101110111100001110110101
00000100100011010110000111001101100101111
00000100100011100110001111110110010101001
00000100100101000011111100011011001110101
00000100100101010001111100011011001110101
00000100100110101100001110110001110110101
00000100100110111100001110110001110010101
00000100101001001110110101000111100011011
00000100101001001111110101000110100011011
00000100101010000100010101111101110011011
00000100101010001100010100111101110011011
00000100101010100011011000100101101101111
00000100101010110000101110000110111101101
00000100101011000100010101111100110011011
00000100101011001101111101000110000111001
00000100101101110001111100011010001100101
00000100110010001010001111100111001101011
00000100110010001010001111101111001001011
00000100110011010000011110100111001110101
00000100110100101111001100100011010101011
00000100110111000011000110011111010010101
00000100110111001011000110011111000010101
00000100111010001010001111101111001000011
00000101001000101100100011110100111101011
00000101001011001100000101011111101000111
00000101001011011111011000010010011001101
00000101001100101110001010010001101011111
00000101001101111101000111000110000101011
00000101010010100011110110110100100011011
00000101010010100100010111110100101100111
00000101010010110111110110000100100110011
00000101010110001001011010001011111010011
00000101010110001001011010001011111100011
00000101011010000010110111010111001100011
00000101011111100000111001001010010110011
00000101100010010000100110111110110100111
00000101100010100011111001010011001100111
00000101100010100011111011010011000100111
00000101100101001000100011101011100110111
00000101100110010010000110111010110100111
00000101100111101101010000101110100010011
00000101101011001100100110000100011101111
00000101101011101000010010001010011110111
00000101110101100010010100010101101100111
00000101110101100010010100011101001100111
00000101110110001111100110100100001010011
00000110001000101101101111000010010111011
00000110001000101111101111000010010011011
00000110001001010010110011010001010111111
00000110001010101110001111010010100011011
00000110001011101110001111010010100001011
00000110010001010000101001011110011110111
00000110010010001000010111111100110001111
00000110010111110100010010100100011010111
00000110011000100111101101000010101011011
00000110011010100011101001000011101011011
00000110011010100011101101000010101011011
00000111010010001000010011011100111001111
00000111010010001000010011111100110001111
00000111011001110101100001000100101001111
00001000010001110110110010101111000011101
00001000010010110011110010110001101110101
00001000010010110011111000110001101110101
00001000010101101101001100111010001010111
00001000010110101000101011110011110010011
00001000010110101000110001110111110010011
00001000010110101000111001110011110010011
00001000100010101100001101111010110001111
00001000100011101101001011110000110010111
00001000100110001011101000011100111101101
00001000101001011110111001000110100010111
00001000101001100100111100001010111111001
00001000101011111011001100011010000110101
00001000101011111011001100011110000110001
00001000110100001010101110001111111001001
00001000110110110011111000010010110010101
00001000110111010011111000010010110010101
00001000111011111000010110101000110010011
00001001001001100010111011100011110100101
00001001001010111101000100110111000011011
00001001001011111000111010101000010110011
00001001010000100101100111110001101110101
00001001010000110100011111010100011011101
00001001010000110110011111010100011001101
00001001010111110110011000100100010100111
00001001011000110111000010110010111010101
00001001011000110111000010110011101010101
00001001011001011000110101000110111010101
00001001011001011000110111000100111010101
00001001011001101000111110000100111010101
00001001101001011100111001000110100010111
00001001101100100110000101101010001110111
00001001110011111011010001010100110000101
00001001111001011100111001000110100010011
00001010000110000101101100100110011101111
00001010001011111001100110001000101101101
00001010010001011001000110101001111010111
00001010010010101001100100011100110110111
00001010010011111001100110101000101001101
00001010010100010001110101110011001001111
00001010010110101000111011110001010010011
00001010011010101100100011100100011110101
00001010101110000111101001001010011001101
00001010110000101011010000110010011111011
00001010110100101110001001001111101000011
00001010110101101110001001001101101000011
00001010111000100011010000110010011111011
00001011000100111001011101101000101010011
00001011001010010001000111010111001001111
00001100010010100100010111110100101100111
00001100010010100111110100010100110110011
00001100010111110100010010101100001110011
00001100010111110110011000100100010100111
00001100011110010111110100010100100010011
00001100101010100100010001110110100101111
00001100110111010100010010101100001110011
