00000000000000000000000010111
00000000000000000000000100111
00000000000001000000000000111
00000000000000000000010001011
00000000000000100000000001011
00000000000000000000001010011
00000000000000000001000010011
00000000000000010000000010011
00000000000010000000000010011
00000000000000000000010100011
00000000000000000000100100011
00000000000000000100000100011
00000000000000010000000100011
00000000000000000000101000011
00000000000000000010001000011
00000000000000001000001000011
00000000000000010000001000011
00000000000100000000001000011
00000000000000000001010000011
00000000000000001000010000011
00000000000010000000010000011
00000000000100000000010000011
00000000000000000010100000011
00000000000000000100100000011
00000000000000100000100000011
00000000000001000000100000011
00000000000100000000100000011
00000000001000000000100000011
00000000000000000101000000011
00000000000000001001000000011
00000000000000010001000000011
00000000000010000001000000011
00000000010000000001000000011
00000000000000001010000000011
00000000001000000010000000011
00000000010000000010000000011
00000000000000010100000000011
00000000000000101000000000011
00000000000001010000000000011
00000000000000000000010001101
00000000000000000000100001101
00000000000000100000000001101
00000000000001000000000001101
00000000000000000000100010101
00000000000000000010000010101
00000000000000000001000100101
00000000000000001000000100101
00000000000000010000000100101
00000000000000100000000100101
00000000000010000000000100101
00000000000000100000001000101
00000000000000000010010000101
00000000000000000100010000101
00000000000000010000010000101
00000000000010000000010000101
00000000000100000000010000101
00000000000000001000100000101
00000000000001000000100000101
00000000000100000000100000101
00000000001000000000100000101
00000000000000001001000000101
00000000000000010001000000101
00000000000000100001000000101
00000000000001000001000000101
00000000001000000001000000101
00000000000000010010000000101
00000000000000100010000000101
00000000000010000010000000101
00000000000001000100000000101
00000000010000000100000000101
00000000000010001000000000101
00000000000100010000000000101
00000000000000000010000011001
00000000000000000100000011001
00000000000000100000000011001
00000000000001000000000011001
00000000000000000100000101001
00000000000000010000000101001
00000000000001000000000101001
00000000000000001000001001001
00000000000001000000001001001
00000000000010000000001001001
00000000000000010000010001001
00000000000100000000010001001
00000000001000000000010001001
00000000000000001000100001001
00000000000000100000100001001
00000000000010000000100001001
00000000000100000000100001001
00000000000000010001000001001
00000000000000100001000001001
00000000000100000001000001001
00000000000000100010000001001
00000000000001000010000001001
00000000000010000010000001001
00000000001000000010000001001
00000000000100000100000001001
00000000001000001000000001001
00000000010000001000000001001
00000000000000010000000110001
00000000000000100000000110001
00000000000001000000000110001
00000000000010000000000110001
00000000000000100000001010001
00000000000010000000001010001
00000000000000010000010010001
00000000000001000000010010001
00000000000010000000010010001
00000000000010000000100010001
00000000000100000000100010001
00000000000000100001000010001
00000000000001000001000010001
00000000000100000001000010001
00000000000100000010000010001
00000000001000000010000010001
00000000001000000100000010001
00000000010000000100000010001
00000000001000010000000010001
00000000010000010000000010001
00000000000000100000001100001
00000000000001000000001100001
00000000000010000000001100001
00000000000010000000010100001
00000000000100000000010100001
00000000000010000000100100001
00000000001000000000100100001
00000000000001000001000100001
00000000000010000001000100001
00000000000100000010000100001
00000000010000000010000100001
00000000000100000100000100001
00000000001000001000000100001
00000000000000100000011000001
00000000000001000000011000001
00000000000100000000011000001
00000000000010000001001000001
00000000000100000001001000001
00000000010000000100001000001
00000000000100000001010000001
00000000001000000001010000001
