00010111111101111
00011011011111111
00011011111011111
00011101101111111
00101011111011111
00101011111101111
00101101110111111
00101110011111111
00101110111101111
00101110111111101
00101111011101111
00101111011111011
00101111101110111
00101111111010111
00101111111100111
00110101011111111
00110101110111111
00110101111110111
00110101111111011
00110110101111111
00110111101011111
00110111110101111
00110111111010111
00111010110111111
