0000010110111
0000011010111
0000101011011
0000101100111
0000101110011
0000110101011
0001000101111
0001001001111
0001001010111
0001001101011
0001001111001
0001010011011
0001010011101
0001011010011
