0000000000000001010001010101
0000000000000001010100010101
0000000000000011000100010011
0000000000000100010001010101
0000000000000100010100010101
0000000000000100010101000101
0000000000000101000100010101
0000000000001001000100011001
0000000000010000010100010101
0000000000010000010101010001
0000000000010001000001010101
0000000000010001000100010101
0000000000010001000101000101
0000000000010001000101010001
0000000000010001001000010011
0000000000010001010000010101
0000000000010001010001010001
0000000000010001010100000101
0000000000010001100000011001
0000000000010010001000100011
0000000000010100000001010101
0000000000010100000101000101
0000000000010100010000010101
0000000000010100010001000101
0000000000100001000100010011
0000000000100001000100110001
0000000000100010000100100011
0000000001000000010001010101
0000000001000000010101000101
0000000001000000010101010001
0000000001000001000001010101
0000000001000001000100010101
0000000001000001000101000101
0000000001000001000101010001
0000000001000001010000010101
0000000001000001010001000101
0000000001000001010100000101
0000000001000001010100010001
0000000001000001010101000001
0000000001000100000001010101
0000000001000100000101000101
0000000001000100000101010001
0000000001000100010001000101
0000000001000100010001010001
0000000001000100010100000101
0000000001000101000000010101
0000000001000101000001000101
0000000001000101000001010001
0000000001000101000100000101
0000000001000101010000000101
0000000001010000000100010101
0000000001010000010001000101
0000000001010001000000010101
0000000010000001000100011001
0000000010000001000110010001
0000000010001000000110001001
0000000100000001000000110011
0000000100000001000001010101
0000000100000001000010011001
0000000100000001000100010101
0000000100000001000100100011
0000000100000001000101000101
0000000100000001000110001001
0000000100000011001000010001
0000000100000100000001010101
0000000100000100000100010101
0000000100000100000101000101
0000000100000100000101010001
0000000100000100010001000101
0000000100000100010001010001
0000000100000100010100000101
0000000100000100010100010001
0000000100000101000000010101
0000000100000101000001000101
0000000100000101000001010001
0000000100000101000100000101
0000000100000101000100010001
0000000100000101010000010001
0000000100001001100000010001
0000000100010000000100010101
0000000100010000000100100011
0000000100010000000101000101
0000000100010000001000010011
0000000100010000010000010101
0000000100010000010001000101
0000000100010000010001010001
0000000100010000010100000101
0000000100010000010100010001
0000000100010000100000011001
0000000100010001000001000101
0000000100010001000001010001
0000000100010001000100000101
0000000100010001000100010001
0000000100010010000000110001
0000000100010100000001010001
0000000100010100000100000101
0000000100010100010000000101
0000000101000001000100000101
