000000011011111010111101101010111011011111
000000110101100111110110110101111110111011
000000111000111000110110110110111111111111
000001001101111010111110011011111011110011
000001010111001111100101111101111001110111
000001010111101111110011011110110100110111
000001011001001111101101010011111111110111
000001011100101011111110111010001111101111
000001011100111110111110001011110110111011
000001011101110010111101101001111111011101
000001011110011101111011001110010111011111
000001011110111111011110001011100110110111
000001011111111111011010101101100111000111
000001100011110001111011001101111110111111
000001100011110111011101010101101101111111
000001100011110111111011001101111110001111
000001100111101101011010101110101110111111
000001101011100110101110101111001101111111
000001101011100110101110111111001101101111
000001101011110001111011001100111110111111
000001101011110011111011001100111110101111
000001101101111101100011111111010101100111
000001101110001101100101011111011111101111
000001101111110011111011001100011110101111
000001101111110110101111001101011101100111
000001101111110111111011001100011110001111
000001110101101101111110011000111101110111
000001111011011011100111010010111011101111
000010000101110100111111100111011111101111
000010010100110101111111100111011110101111
000010010111011001101101011010111111011111
000010010111110010111011100011101110111111
000010011011110001101011110101111111001111
000010011101011101101101011011000111111111
000010011101011111001010110111111001011111
000010011111001011101010110111101011111011
000010011111011011101110101111001011110011
000010011111100111111010110101110111010011
000010100011111101001101110111101111011011
000010100101110111101101011101100101111111
000010100110100101110111110110011111011111
000010100111101111011101001111111101001101
000010101001111110101111111101100001111011
000010101011010101111100011111011111101101
000010101011100111111110110100011101101111
000010101011111101111100011111011010101101
000010101110011101111100011111011011101101
000010101110111100110110101111100111011011
000010101110111110011111101100011111100011
000010101111101011111111011010001100111101
000010101111101111110010011111001010111011
000010110011110100101110011011101011111111
000010110100011111101111001011111011101011
000010110100110011111111101010111100111011
000010110101011010101000111110111111011111
000010110101110111110010111100101110111011
000010110110010111011100110101011111101111
000010110111001110101000111110111011011111
000010110111010111001000111111011011101111
000010110111011010101000111110101111011111
000010110111011010111000111110101111011101
000010110111101011001111110101111010110011
000010110111111010111000111110101011011101
000010111000111101011001101111110111101011
000010111001001110111000111101111111101011
000010111001111111110100010111101101100111
000010111010111110111111000110111011001011
000010111011001010011111010011101111101111
000010111011010101101100011101011111101111
000010111011011101101100011101011110101111
000010111011101011110010111111011101001011
000010111011101111111010100011011111001011
000010111011111001011010100011011101111111
000010111100111010110110011100101110111111
000010111100111110110100111111101010110011
000010111101110110011110011101101010111011
000010111101111100110100010111001101111111
000010111110010011011100011010111111101111
000010111110011010011001010110111111101111
000010111110101110100011011011110011110111
000010111110111010111001011011001110011111
000010111110111101011001101111000111101011
000010111110111110111101000110111011001011
000010111110111110111111000010111111000011
000010111110111110111111000011000010111111
000010111110111110111111000011000100111111
000010111110111110111111000100111011001011
000010111111011101101100011101010011101111
000010111111101110110101010011001110011111
000010111111101111100011110111011000101011
000010111111110111101100111010101001100111
000011000100101111101110010111110111110111
000011000100111110111110111011001010111111
000011000110111110111110111011001010110111
000011001010011110111110111011000110111111
000011001100111111001010111110111110010111
000011001101010111101001111011101110110111
000011010001111010111011011011101111100111
000011010001111110101011110011100111111011
000011010001111110111011110010100111111011
000011010010111001111101101010111011111011
000011010010111101111001101010111011111011
000011010101101110001001101111110111011111
000011010101101111101000111111111011000111
000011010101101111101100010111111011001111
000011010101110111101100010111111011001111
000011010101111000111011011011001111110111
000011010101111100111011011011001111010111
000011010101111110111011011011001111000111
000011010101111111101100010111110011001111
000011010110011101011101101010011111011111
000011011001011100111011011010101111110111
000011011001111100111011011010101011110111
000011011001111100111011011010101111010111
000011011101111100111011011010001111010111
000011011110011001011010101110111111001111
000011011110111010101110011000111110110111
000011011111101111100110010100101100111111
000011100010110101111011011101110110011111
000011100100101111101110010101110111110111
000011100101000110111110101101110111011111
000011100110110011111011011101010110101111
000011101010011101101100010111111011101111
000011101010110001111011011100110110111111
000011101010110011111011011100110110101111
000011101010110111111011011100110110001111
000011101011011101101100010111011110101111
000011101011110101101100010111011011101111
000011101101010100110111101111011011001111
000011101101011001111111001101010110110111
000011101110110011111011011100010110101111
000011101111110110101001101111001100101111
000011110111011010101000110110101111011111
000011110111011101110101011010011001011111
000011110111111010101000110110101011011111
000011110111111011100110110100100010111111
000100010011110011010111101001111111011111
000100010101110011111011010011111110110111
000100010110111110011110011011110110111101
000100010110111111110101111101010100101111
000100011010010111111101111100011110111011
000100011011000101110110111100111101111111
000100011100100110111010110101111101111111
000100011100100110111010110101111111011111
000100011100100110111011110100111101111111
000100100101101111110011100111101010111111
000100100110110011011010110101111110111111
000100100110110111101110011101010101111111
000100100110110111111010110101111110011011
000100100110111110111000101111011010111111
000100100111110011011010110101110110111111
000100100111110111011010110101110110011111
000100100111111101101101010111101001101111
000100101010111110110111100011111111010011
000100101011001011111111010111001101111101
000100101011100011101111111110110010111101
000100101011111110010111110011110111010011
000100101100010111110110101101111111011101
000100101100111010111000110111111100111111
000100101101010111011101101101111000111111
000100101110110011010010110101111110111111
000100101110111011010110111101110110001111
000100101111101110010111110101110111100011
000100101111110111011010110100110110011111
000100101111110111111010110100110110011011
000100110011011001101010101111011111101111
000100110011011101111010101111011111001101
000100110011111001101010101111011011101111
000100110011111101101010101111011011001111
000100110101100111100010101101011111111111
000100110101100111110010101101001111111111
000100110101111001111111000110101111010111
000100110101111010111111000110101111001111
000100110111100011010101111101111101101011
000100110111100110101011010101111101011111
000100110111100110101110010101111111011101
000100110111100110101111010101111100011111
000100110111101110101111001111111000101101
000100110111101111100010111110011010101111
000100110111101111101000111111011110001101
000100110111111011110111100010101110100111
000100111010010011110111110001011101111111
000100111010110010110111100011111111011011
000100111010111010110111100011111111010011
000100111011001011111000111101111101101011
000100111011110101111101111001100101101011
000100111011111101101010101110011011001111
000100111011111101111010101110011011001101
000100111100010111110010101101111111011101
000100111100100110111000110101111111011111
000100111110001011011111111010111000111011
000100111110110011110110111110011110010101
000100111111001100101111011111111001100101
000100111111111001101101100011101010110111
000101000101011011111110011110111011011011
000101001001101110111101001011111111010111
000101001001101111111011100111101010011111
000101001010110101111001111001111110111011
000101001011100111100110111101001111111101
000101001011101101110011110111100101111101
000101001011110111111001111001110110101011
000101001101010001111110011101101111101111
000101001101100111101111100101101111001111
000101001110010011110111011001101011111111
000101001110110101011001111001011110111111
000101001110110101111001111001011110111011
000101001110110111011001111001011110101111
000101001111000101111111101011011001110111
000101001111001111100101101111101101100111
000101001111010011110111011001101011111101
000101001111011111010101001111111000111011
000101001111110101111001111001010110111011
000101010011001111110111011010011001111111
000101010011011101011001111010110111011111
000101010011011101111111100101011011110011
000101010011101011110011101110110010111111
000101010011101101100111111110011110110101
000101010101101101110011110011101101111101
000101010110111111001100111101101101001111
000101010111001101101111010110111100111101
000101010111011011110101101000111001111111
000101010111101100100101111110011110110111
000101010111101101100110111110011110110101
000101011000101111111010011011101111001111
000101011001001110101101010011111111110111
000101011001001111101011010011111101110111
000101011001100111101111101101011010011111
000101011001100111111111100101101010011111
000101011001100111111111101101001010011111
000101011010010111111101111100011100111011
000101011011011101011100111010011111110011
000101011011100011001111101101111110011101
000101011011100101100100111101011111111101
000101011011101110110100111111010101100111
000101011100101101110011110011101101111101
000101011101111010010111011111100101101011
000101011111110011101101001001101111010111
000101011111110110011101001011010011111011
000101100011110100111010101001111111110111
000101100011110100111011101101111110010111
000101100101110111111011101101001110001111
000101100110010101011100110111101111111101
000101100110010111011010111101111010011111
000101100111001111101111000111101101101101
000101100111010011010110011101111111101011
000101100111010011011010111101110010111111
000101100111010011011110010101111111101011
000101100111010011011110011101101111101011
000101100111010011111010111101110010111011
000101100111010110101111101001111101100111
000101100111010111011010111101110010011111
000101100111110010111011101101011110100111
000101100111110011001010111101110110111101
000101100111110111001010111101110110011101
000101100111111100101011110110111110100011
000101100111111110111010101001011110100111
000101101001100110111010111101101001111111
000101101001100111011101110100110011111111
000101101001110001111011101100101110111111
000101101001110011111011101100101110101111
000101101001110101111011101100101110011111
000101101010100111011001111101111100101111
000101101011100101111001111101110100111011
000101101011101000101110111111111001100111
000101101011110010111011101100111110100111
000101101011110111001111111101011001010011
000101101110010111111010111100111010011011
000101101110100101011001111101011100111111
000101101110100101111001111101011100111011
000101101110100111111001111101011100101011
000101101110101111101000111011110110001111
000101101110110111001010111100111110011101
000101101111010011111110011101100011101011
000101101111010111011010111100110010011111
000101101111100101111001111101010100111011
000101101111110010111011101100011110100111
000101101111110111001010111100110110011101
000101101111111001011110011100111010011011
000101101111111100011111010101001011110011
000101110001101011110100101111111101011101
000101110001110011010010101101111111111101
000101110001110011011010100101111111111101
000101110011111101101010100111011011001111
000101110101100011101001011110101111111101
000101110101101001110001100111111111011101
000101110111001111010111001010110011111101
000101110111111101010011101001001101011111
000101111000111101011001001111110111110011
000101111000111111011001001111110111100011
000101111001111101011011111010110011010011
000101111001111101101001110111010101100111
000101111010111101011001001111100111110011
000101111010111110011001001111100111101011
000101111011011101101010100110011111001111
000101111100111010010100110111110111110011
000101111100111110011001001111010111101011
000101111100111111011001001111010111100011
000101111101010110011111101110110100100111
000101111101101011011001110111010011001111
000101111111010110011111101010110100100111
000101111111011101011110011010010011001111
000101111111101111011000110101010011001111
000101111111110011011101011011010011100011
000110010101010111110100111110100111011111
000110010101110111110100111110100111011011
000110010101111100110111111010011001011111
000110010110010111111101010100111110111011
000110010111011111101001010011111001111011
000110011001001111101011010101111101110111
000110011010010101111101111000111110111011
000110011010011101001111001010111111111011
000110011100100101010110110101111111101111
000110011111100101010100110101101111101111
000110011111100111111010100101100101110111
000110011111100111111010100101100111010111
000110100101011100111100111111011000111111
000110100101011101011100111111011000111111
000110100101100111101100111110101011111011
000110100110010101011101111011010110111111
000110100110110011111010100101111110111011
000110100110110111101110011001010101111111
000110100110110111111010100101111110011011
000110100111110011111010100101110110111011
000110100111110111011010100101110110011111
000110101001011101101100111111001110101111
000110101001100101111100111111001011101111
000110101001110101111100111111001001101111
000110101011010100101100111111011111100111
000110101011100101111110110110011101001111
000110101011101001111110110110011100101111
000110101011110011111101110101001001101111
000110101100111111001101101110101001011111
000110101110110111011010100100111110011111
000110101110110111111010100100111110011011
000110110010011101101010111111010111001111
000110110010011101111011111110010101001111
000110110010100110110010110101111011111111
000110110010101001111011111110010011101111
000110110010111001101010111111010011101111
000110110010111101101010111111010011001111
000110110011010101011111111001001011110111
000110110101010101111011111110010011100111
000110110110011101111100100111101101010111
000110111001010101101100111101001111101111
000110111001101100101001101111010111101111
000110111010111101101010111110010011001111
000110111011010100101100111101011111100111
000110111011011111001110101001001011111011
000110111110110010101001110001111110110111
000110111111010111010101010100101100111111
000110111111011010101110011110100100110111
000111001010011111001001011011101110111111
000111001010110111011001101001111110101111
000111001011011001111110111010011010101111
000111001011110101011001101001110110111111
000111001101111101010100101011001011111111
000111001110110101011001101001011110111111
000111001111110101011001101001010110111111
000111010010011101011111111011001010110111
000111010011011001111110111001011010101111
000111010101101100100101111011011110110111
000111010101101100100101111101011110110111
000111010101101100100101111111011010110111
000111010101101101001100111111111001001111
000111010111001010110011111101001101110111
000111011001001101101011010101111101110111
000111011001001111101011010100111101110111
000111011100100111010100110101111110101111
000111011101010110101001011001101110111111
000111100110010011011010101101111010111111
000111100110010011011110111101101010011111
000111101001010101101100110111001111101111
000111101010100101011001101101111100111111
000111101101010011011110111100110010011111
000111101110100101011001101101011100111111
000111101111010111011010101100110010011111
000111101111100101011001101101010100111111
000111110101011011110100110010100110111111
