00000000000100000000000100010101
00000000000000010000010000010101
00000000000001000000010000010101
00000000000100000000010000010101
00000000000000010001000000010101
00000000000001000001000000010101
00000000000100000001000000010101
00000000000000010000000101000101
00000000000001000000000101000101
00000000000001000000010001000101
00000000000000010100000001000101
00000000000001000100000001000101
00000000010000000100000001000101
00000000000000010001000100000101
00000000000001000001000100000101
00000000000001000100000100000101
00000000000100010000000100000101
00000000010000010000000100000101
00000000000000010001010000000101
00000000000001000001010000000101
00000000000100010000010000000101
00000000010001000000010000000101
00000000000100010001000000000101
00000000000000010000000101010001
00000000000000010001000001010001
00000000000100000001000001010001
00000000010000000001000001010001
00000000000100000100000001010001
00000000010000000100000001010001
00000000000000010000010100010001
00000000000100000000010100010001
00000000000100000100000100010001
00000000010000010000000100010001
00000000000100000101000000010001
00000000010000010001000000010001
00000000010000010100000000010001
00000000010000000100010001000001
00000000010000000101000001000001
