0000111011101111111111
0000111011111101111111
0000111101110111111111
0001011101111011111111
0001011111011110111111
0001011111101111011111
0001011111101111110111
0001011111110111101111
0001100111111011111111
0001101011111011111111
0001101101101111111111
0001101101111011111111
0001101110101111111111
0001101111011111011111
0001101111101110111111
0001101111101111011111
0001101111111011011111
0001101111111011101111
0001101111111101011111
0001101111111110011111
0001110101101111111111
0001110110101111111111
0001110110110111111111
0001110110111011111111
0001110111011011111111
0001110111110110111111
0001110111111011011111
0001110111111101101111
0001111001101111111111
0001111011001111111111
0001111011101101111111
0010010111111110111111
0010011011110111111111
0010011101111101111111
0010011110101111111111
0010011110111110111111
0010011111011110111111
0010101110110111111111
0010101111001111111111
0010101111100111111111
0010101111101111011111
0010101111101111110111
0010101111101111111101
0010101111110111101111
0010101111110111111011
0010101111111011011111
0010101111111110011111
0010101111111111001111
0010110101110111111111
0010110111001111111111
0010110111011101111111
0010110111011111101111
0010110111101110111111
0010110111111011101111
0010110111111101110111
0010111001110111111111
0010111010110111111111
0010111011011111110111
0010111011100111111111
0010111011101111011111
0010111011101111111101
0010111011110101111111
0010111011110110111111
0010111011110111101111
0010111011110111111101
0010111011111101101111
0010111011111101111011
0010111100110111111111
0010111100111111111011
0010111101011101111111
0010111101011111111011
0010111101110101111111
0010111101110111011111
0010111101110111101111
0010111101110111110111
0010111101110111111011
0010111101111011111011
0010111101111101110111
0010111110011101111111
0010111110101111110111
0010111110110111110111
0010111110111011111101
0010111111010111110111
0010111111011101101111
0010111111011101111011
0010111111100111011111
0010111111100111110111
0010111111101110011111
0010111111101111010111
0010111111101111011011
0010111111110101110111
0010111111110101111011
0010111111110110110111
0010111111110111001111
0010111111110111100111
0010111111110111101011
0010111111111100111011
0011001110101111111111
0011001111010111111111
0011001111101011111111
0011010110101111111111
0011010111011110111111
0011010111101101111111
0011010111101110111111
0011010111101111111011
0011010111110011111111
0011010111110110111111
0011010111110111111011
0011010111111010111111
0011010111111100111111
0011010111111110011111
0011010111111110110111
0011011010101111111111
0011011010110111111111
0011011011010111111111
0011011011110101111111
0011011011111110101111
0011011011111111010111
0011011101011110111111
0011011110101110111111
0011011110101111011111
0011011110101111101111
0011011110111010111111
0011011111010110111111
0011011111010111101111
0011011111011010111111
0011011111011110101111
0011011111101101011111
0011011111101110101111
0011011111110110101111
0011011111111010101111
0011101010110111111111
0011101011011111110111
0011101011101101111111
0011101011111011011111
0011101011111110110111
0011101101011111011111
0011101101101011111111
0011101101110101111111
0011101111101011011111
0011101111101101011111
0011101111110101101111
0011110101101110111111
0011110101110110111111
0011110110101011111111
0011110110101110111111
0011110111010110111111
0011111010101101111111
0011111010110111011111
0011111011010101111111
