0000110111111111110111111011111111111101111111
0000111110111011111111111110111101111111111111
0000111110111111111111111110111101110111111111
0001001111110111110111111110111111111111111111
0001011111110111111111111110011111111111101111
0001011111111111101111111110111111101111101111
0001011111111111110111111110111111101111011111
0001100111111011111111101111111101111111111111
0001101111011111101111101111111111111011111111
0001101111101111111011111110111111011111111111
0001101111111011011111101111111111111111110111
0001101111111111011111011111101111111110111111
0001101111111111110111111011111111111011011111
0001110110111111111101111011111111101111111111
0001110111101101111111011111101111111111111111
0001110111111101111111111110110111111011111111
0001110111111110110111111001111111111111111111
0001110111111111011111111110110111111110111111
0001110111111111011111111111011011111110111111
0001110111111111111111011111101111011011111111
0001111011101101111111011111110111111111111111
0001111011101111111111110110111111111110111111
0001111011110110111111110111011111111111111111
0001111011111111111111011111110111011011111111
0001111111011101101101111011111111111111111111
0001111111011101101111101111011111111111111111
0001111111101011101101111011111111111111111111
0001111111101110110110101111111111111111111111
0001111111110111011001111011111111111111111111
0010011110111101111011111101111111111111111111
0010101111011111111111111101111101111101111111
0010101111101111011111101111111101111111111111
0010101111110111111111111110011111111111101111
0010101111111101111101101111111111111110111111
0010101111111101111111110111111011111111111011
0010101111111110111110011111111111111101111111
0010101111111111110111111101110111111111011111
0010110110111111111111111101111110111011111111
0010110111011101111111011111101111111111111111
0010110111011111111111001111111111111101111111
0010110111111011111011101111111111111101111111
0010110111111011111111110111111101111111111011
0010110111111111101110111111111111111110011111
0010110111111111111111011111101110111011111111
0010110111111111111111110111111101110111111011
0010111001111111110110111111110111111111111111
0010111011011111111111011111110111101111111111
0010111011110111111111011111110110111111111111
0010111011111111011110111101111111111101111111
0010111011111111101111111101011111111111101111
0010111011111111111111110111111110011111110111
0010111101100111111111111011111011111111111111
0010111101111011101111101111011111111111111111
0010111101111011111011101111111111111111011111
0010111101111101111101110111101111111111111111
0010111101111101111111111101110111111110111111
0010111101111110111111111111011101111101111111
0010111101111111011111011101111111111011111111
0010111101111111101111101111111111110111110111
0010111101111111101111110111011111011111111111
0010111101111111111111110111101111011111111011
0010111101111111111111111011111011001111111111
0010111110011011111111110111101111111111111111
0010111110110111011111111101111011111111111111
0010111110111110111111111101111111111011110111
0010111110111111011111111101111011101111111111
0010111110111111111001111111111111011111110111
0010111110111111111111110111101110110111111111
0010111111001111111111110111110111111111110111
0010111111010111011111110111101111111111111111
0010111111011101111111111101111101111111101111
0010111111011110111111111101111111011111111011
0010111111011111110111011110111110111111111111
0010111111011111111110110111111111111011101111
0010111111011111111111011111101110111111101111
0010111111101101101111101111111111111111110111
0010111111101101111101111101111111111111110111
0010111111101110111101111101111110111111111111
0010111111101110111111110111111111111111100111
0010111111110101110111101111111111111110111111
0010111111110110111101111111111111110111111011
0010111111110111011011111101111111111111101111
0010111111110111110111111101111111111110110111
0010111111110111111111110111101110111110111111
0010111111111011100111111111111111111101011111
0010111111111011111011111110111111111101110111
0010111111111011111101111111111111101101111011
0010111111111101111111011111111011111011110111
0010111111111110111011111110111111110111110111
0010111111111110111101111111111111110101110111
0010111111111110111110111101110111111110111111
0010111111111111011101111101111110111101111111
0010111111111111011111101111011101111101111111
0010111111111111011111101111110111111011101111
0010111111111111101111111011100111111111011111
0010111111111111101111111110011101111111011111
0010111111111111101111111110111111101111010111
0010111111111111111011111101111101111011101111
0010111111111111111101110111111001111011111111
0010111111111111111111101111011101011110111111
0010111111111111111111110110111011110111101111
0011001111011111111111101011111111111110111111
0011001111111010111110111111011111111111111111
0011010110111111011111111110111110111111111111
0011010111101111111111101111111101111110111111
0011010111110111111011111110111111110111111111
0011010111110111111111101111110111111011111111
0011010111111001111111110111111011111111111111
0011010111111011101111111110111111101111111111
0011010111111011111101101111111011111111111111
0011010111111011111110111111011111110111111111
0011010111111101111110101111111111011111111111
0011010111111111011110111011111111111110111111
0011010111111111110111111111100111111011111111
0011010111111111111101111111101111101111110111
0011011010111111110111110111111111011111111111
0011011010111111111011111111110110111111111111
0011011011111111111111011110111111111010111111
0011011101011110111111111111111110011111111111
0011011101101011111111111011111011111111111111
0011011101111111111111111011111011010111111111
0011011110101111011111101111101111111111111111
0011011110101111110111110111110111111111111111
0011011110111110101111011110111111111111111111
0011011110111110111101011111111101111111111111
0011011110111111101111111101011111111111011111
0011011110111111101111111111101011111111011111
0011011110111111111010111011111101111111111111
0011011111001111111111111111111010111101111111
0011011111010111101111111111111111100111111111
0011011111011110101111101111111111101111111111
0011011111011110101111111111111111111001111111
0011011111011111010110101111111111111111111111
0011011111011111111101111111011110101111111111
0011011111101011111111110111111101111111101111
0011011111101111010111110111111111111011111111
0011011111101111101011110111111111111101111111
0011011111101111111011110111111111111101011111
0011011111110111100111111010111111111111111111
0011011111110111101011101111111111111011111111
0011011111110111101011111101111111111111011111
0011011111110111111111111010111111111111001111
0011011111110111111111111110101111110111110111
0011011111111010111101101111101111111111111111
0011011111111010111111110111111111111111010111
0011011111111011010111111111111111111110011111
0011011111111011111111110111111101011111101111
0011011111111011111111111110101111101111011111
0011011111111101111101111111111111101011110111
0011011111111101111110101111101111011111111111
0011011111111110101111110111111111110111110111
0011011111111111101111101111111111101011110111
0011011111111111101111111010111101111101111111
0011011111111111110011111111111011111110101111
0011011111111111110101111111011111101111101111
0011011111111111110111110111111111011010111111
0011011111111111111110101111111110111100111111
0011011111111111111111101111100111101011111111
0011011111111111111111110111101011110011111111
0011101010111111111111011111111101101111111111
0011101011011011111111110111111011111111111111
0011101011011111110111111111110101111111111111
0011101011110111111101101111111111111011111111
0011101011111101111111111101101111111011111111
0011101011111110110111111110110111111111111111
0011101011111111011110110111111111011111111111
0011101011111111011111111101101111111110111111
0011101011111111101101111111011111111111110111
0011101011111111101111111111011011111101111111
0011101011111111111111110011111111101101111111
0011101101101111111111010111111111111111110111
0011101101101111111111101011111111111101111111
0011101101111101111011111111101011111111111111
0011101101111101111111101011111111101111111111
0011101101111110101111011111011111111111111111
0011101101111111111101110101111111111011111111
0011101101111111111111011111011111101011111111
0011101101111111111111111011011111111101011111
0011101110101111110111111111111101101111111111
0011101110110101111111111111111011111011111111
0011101111010111110111111111111101101111111111
0011101111011111111111111011011111111110101111
0011101111101101111110101111111111111101111111
0011101111101111111011010111111011111111111111
0011101111110101111101101111110111111111111111
0011101111110101111111011111011011111111111111
0011101111110110111110101111111111011111111111
0011101111111101011111111111111110110110111111
0011101111111110110111111111111111011101011111
0011101111111111011111101101111101011111111111
0011101111111111110111111101011011111111011111
0011101111111111111101101101111111111010111111
0011110101011111111110110111111111101111111111
0011110101111110110111011111111111111111101111
0011110101111111111101101110111111110111111111
0011110110101111111111101110111111111111011111
0011110110101111111111111111111011011101111111
0011110110111011111011111111110101111111111111
0011110110111111111010101111110111111111111111
0011110111011111111111111110101101111111011111
0011110111110110111011111111111111110101111111
0011110111111010111011111111111111110110111111
0011110111111110101011110110111111111111111111
0011110111111111111011101101111111110101111111
0011110111111111111111101110111111011010111111
0011111010110111111111011101110111111111111111
0011111010110111111111011111111111101110111111
0011111010110111111111111011111101110111111111
0011111011011110111011111111110101111111111111
0011111011101111011010110111111111111111111111
0011111011101111111111011111111111011010111111
0011111011101111111111111111101101011011111111
0011111011110111011111110101101111111111111111
0011111011111101010111101101111111111111111111
0011111011111110110101110111111111110111111111
0011111011111111110101101111011101111111111111
0011111011111111111101110111111101101011111111
0011111011111111111111011101110101101111111111
0011111011111111111111110111011010110111111111
0011111101011101111011111111111011011111111111
0011111101101011101111111111111001111111111111
0011111101101011111111010111011111111111111111
0011111101101111111111111111101101011101111111
0011111101110111110110101111111111111011111111
0011111101111110111010110111111111110111111111
0011111101111111110101011011111011111111111111
0011111110110111111111111011110101110111111111
0011111110111011010111011111111111110111111111
0011111110111101111111111111011011101011111111
0011111110111111111111011111010101101111111111
0011111111011011110101110111111011111111111111
0011111111011101101011111011111111111011111111
0011111111011101111110101101101111111111111111
0011111111101101101011101101111111111111111111
0011111111101111011011101011111111110111111111
0011111111101111011110110111010111111111111111
0011111111101111110101110110111101111111111111
0011111111101111111011111010110111011111111111
0011111111110101110110101111111011111111111111
0011111111111011010110101110111111111111111111
0011111111111011011010101111110111111111111111
0011111111111011111111010101101101111111111111
