00000001010100010001000001000001010001010001010101
00000001010100010000010100000100010000010101010101
00000001010001010100010001000001000101000001010101
00000001010001000100010100000100000101010100010101
00000001000101010100010100000100010001000001010101
00000001000101010001010100010100010000010000010101
00000001000101010000010001010101010001000100000101
00000001000101010000010000010001010101010000010101
00000001000101010000010000010001000101010001010101
00000001000101000101010101000001000001000100010101
00000001000101000001010101010100010000010000010101
00000001000100010100010000010101010100000101000101
00000001000100000101010101010001010000010100010001
00000001000100000101010101010001000100000101000101
00000001000100000101010001010001010000010101010001
00000001000100000101000101000101010000010101010001
00000001000100000100010001010100010100000101010101
00000001000100000001000101000101010000010101010101
00000001000001010100010000010101010001010001010001
00000001000001010001000100000001010101000101010101
00000001000001010001000001010101000100010101010001
00000001000001000101010001000001010101010100000101
00000001000001000100010101010000010001010101010001
00000001000000010001010101010100010001010100000101
00000001000000010001010100000100010101010100010101
00000001000000010001010001010001010101000001010101
00000000010101000100000100000001010100010101010101
00000000010100010101010100010100010001000000010101
00000000010100010100010001000101010000010101000101
00000000010100010100000100010001010001010100010101
00000000010100010001000000010100010101000101010101
00000000010100010000010100000100010001010101010101
00000000010100000101000000010001010101010001010101
00000000010001010100010100010101000101010000000101
00000000010001000101000001000001010101010100010101
00000000010000010101000100000101010001000101010101
00000000010000010100010001000101010000010101010101
00000000010000010100000101010001000101000101010101
00000000010000010001010001010100010100000101010101
00000000010000000101000101000101010001000101010101
00000000000101000101000101000100010100010101000101
00000000000101000101000100010100010101000100010101
00000000000101000100010101000001010001010001010101
00000000000101000000010101000001010001010101010101
00000000000100010101000101010001010001010001000101
00000000000100010100000101010001000101010101010001
00000000000100010000010101010001000100010101010101
00000000000100010000010101010000010100010101010101
00000000000001010100010001010001010001010100010101
00000000000001000101010100010100010101000100010101
