00000000011
00000000101
00000001001
00000010001
00000100001
