000011101111111011111111
000011110111011111111111
000101111111011111101111
000101111111101111011111
000110110111110111111111
000110111110111110111111
000110111111011111110111
000110111111110111011111
000111011011011111111111
000111011011110111111111
000111011101101111111111
000111011111101101111111
000111011111110110111111
000111011111111011011111
000111101101110111111111
001010111110011111111111
001010111111011111101111
001010111111101111011111
001010111111111110011111
001011011011101111111111
001011011111011111110111
001011011111101111111011
001011011111110111011111
001011101110011111111111
001011101111011011111111
001011101111011110111111
001011101111111011110111
001011110011101111111111
001011110111010111111111
001011110111011111011111
001011110111111011101111
001011110111111011111011
001011111011101111011111
001011111011101111110111
001011111011110111111011
001011111011111011110111
001011111111010111110111
001011111111011011101111
001011111111011110111011
001011111111101110011111
001011111111101111011011
001100111101011111111111
001100111110101111111111
001101011110111101111111
001101011111100111111111
001101011111101101111111
001101011111101111110111
001101011111111100111111
001101101101011111111111
001101101111111110101111
001101110101101111111111
001101111101011110111111
001101111101011111101111
001101111110101111101111
001101111110111101011111
001101111111010111101111
001101111111101101011111
001101111111101111010111
001110101101101111111111
001110101111011011111111
001110101111110110111111
001110101111111101101111
001110101111111110110111
001110110111010111111111
001110110111111110101111
001110111111101011011111
001110111111110110101111
001111010101101111111111
001111010111011011111111
001111011010101111111111
001111011011101011111111
001111101101011101111111
001111101110101101111111
001111110110101110111111
