0000010111
0000011011
0000100111
0000101011
0001001011
0001001101
0001010011
0001010101
