0000001000001100001010000111
0000001000010100100010010101
0000001000011100001010000011
0000001000100110000011001001
0000001001000100000110010011
0000001001010100100010000101
